AALA__ref	AALA__ref
AAXJ__ref	AAXJ__ref
ABEH__ref	ABEH__ref
ABSS__ref	ABSS__ref
ADHK__ref	ADHK__ref
AEPI__ref	AEPI__ref
AFLV__ref	AFLV__ref
AFQQ__ref	AFQQ__ref
AIOU__ref	AIOU__ref
AJFN__ref	AJFN__ref
ALUC__ref	ALUC__ref
ANI_Anisophyllea_cinnamomoides	ANI_Anisophyllea_cinnamomoides
ANI_Anisophyllea_cinnamomoides__00	ANI_Anisophyllea_cinnamomoides
ANI_Anisophyllea_cinnamomoides__01	ANI_Anisophyllea_cinnamomoides
ANI_Anisophyllea_cinnamomoides__02	ANI_Anisophyllea_cinnamomoides
ANI_Anisophyllea_purpurascens_GSK	ANI_Anisophyllea_purpurascens_GSK
ANI_Anisophyllea_purpurascens_GSK__00	ANI_Anisophyllea_purpurascens_GSK
ANI_Anisophyllea_purpurascens_GSK__01	ANI_Anisophyllea_purpurascens_GSK
ANI_Anisophyllea_purpurascens_GSK__02	ANI_Anisophyllea_purpurascens_GSK
ANI_Anisophyllea_purpurascens_GSK__03	ANI_Anisophyllea_purpurascens_GSK
ANI_Anisophyllea_purpurascens_GSK__04	ANI_Anisophyllea_purpurascens_GSK
ANI_Anisophyllea_purpurascens_GSK__05	ANI_Anisophyllea_purpurascens_GSK
ANI_Combretocarpus_rotundatus	ANI_Combretocarpus_rotundatus
ANI_Combretocarpus_rotundatus__00	ANI_Combretocarpus_rotundatus
ANI_Combretocarpus_rotundatus__01	ANI_Combretocarpus_rotundatus
ANI_Combretocarpus_rotundatus__02	ANI_Combretocarpus_rotundatus
ANI_Combretocarpus_rotundatus__03	ANI_Combretocarpus_rotundatus
ANI_Combretocarpus_rotundatus__04	ANI_Combretocarpus_rotundatus
ANI_Combretocarpus_rotundatus__05	ANI_Combretocarpus_rotundatus
ANI_Poga_oleosa	ANI_Poga_oleosa
ANI_Poga_oleosa__00	ANI_Poga_oleosa
ANI_Poga_oleosa__01	ANI_Poga_oleosa
ANI_Poga_oleosa__02	ANI_Poga_oleosa
ANI_Poga_oleosa__03	ANI_Poga_oleosa
ANI_Polygonanthus_amazonicus	ANI_Polygonanthus_amazonicus
ANI_Polygonanthus_amazonicus__00	ANI_Polygonanthus_amazonicus
ANI_Polygonanthus_amazonicus__01	ANI_Polygonanthus_amazonicus
ANI_Polygonanthus_amazonicus__02	ANI_Polygonanthus_amazonicus
APO_Apodanthes_caseariae	APO_Apodanthes_caseariae
APO_Apodanthes_caseariae__00	APO_Apodanthes_caseariae
APO_Apodanthes_caseariae__01	APO_Apodanthes_caseariae
APO_Apodanthes_caseariae__02	APO_Apodanthes_caseariae
APO_Apodanthes_caseariae__03	APO_Apodanthes_caseariae
APO_Apodanthes_caseariae__04	APO_Apodanthes_caseariae
APO_Apodanthes_caseariae__05	APO_Apodanthes_caseariae
APO_Pilostyles_aethiopica	APO_Pilostyles_aethiopica
APO_Pilostyles_aethiopica__00	APO_Pilostyles_aethiopica
APO_Pilostyles_aethiopica__01	APO_Pilostyles_aethiopica
APO_Pilostyles_aethiopica__02	APO_Pilostyles_aethiopica
APO_Pilostyles_aethiopica__03	APO_Pilostyles_aethiopica
APO_Pilostyles_aethiopica__04	APO_Pilostyles_aethiopica
APO_Pilostyles_aethiopica__05	APO_Pilostyles_aethiopica
APO_Pilostyles_thurberi_RNA	APO_Pilostyles_thurberi_RNA
APO_Pilostyles_thurberi_RNA__00	APO_Pilostyles_thurberi_RNA
APO_Pilostyles_thurberi_RNA__01	APO_Pilostyles_thurberi_RNA
AQGE__ref	AQGE__ref
AQZD__ref	AQZD__ref
ARYD__ref	ARYD__ref
ASMV__ref	ASMV__ref
ATFX__ref	ATFX__ref
ATYL__ref	ATYL__ref
AUGV__ref	AUGV__ref
AUIP__ref	AUIP__ref
AVJK__ref	AVJK__ref
AWJM__ref	AWJM__ref
AXBO__ref	AXBO__ref
AXNH__ref	AXNH__ref
AYIY__ref	AYIY__ref
AYMT__ref	AYMT__ref
AZBL__ref	AZBL__ref
Ambtr__ref	Ambtr__ref
Aquco-v1.1__ref	Aquco-v1.1__ref
Arath__ref	Arath__ref
BAHE__ref	BAHE__ref
BBBA__ref	BBBA__ref
BCAA__ref	BCAA__ref
BCGB__ref	BCGB__ref
BDJQ__ref	BDJQ__ref
BEFC__ref	BEFC__ref
BEG_Begonia_conchifolia_RNA	BEG_Begonia_conchifolia_RNA
BEG_Begonia_conchifolia_RNA__00	BEG_Begonia_conchifolia_RNA
BEG_Begonia_conchifolia_RNA__01	BEG_Begonia_conchifolia_RNA
BEG_Begonia_conchifolia_RNA__02	BEG_Begonia_conchifolia_RNA
BEG_Begonia_coptidifolia_WGS	BEG_Begonia_coptidifolia_WGS
BEG_Begonia_coptidifolia_WGS__00	BEG_Begonia_coptidifolia_WGS
BEG_Begonia_coptidifolia_WGS__01	BEG_Begonia_coptidifolia_WGS
BEG_Begonia_coptidifolia_WGS__02	BEG_Begonia_coptidifolia_WGS
BEG_Begonia_coptidifolia_WGS__03	BEG_Begonia_coptidifolia_WGS
BEG_Begonia_coptidifolia_WGS__04	BEG_Begonia_coptidifolia_WGS
BEG_Begonia_coptidifolia_WGS__05	BEG_Begonia_coptidifolia_WGS
BEG_Begonia_fuchsioides_leaf_RNA	BEG_Begonia_fuchsioides_leaf_RNA
BEG_Begonia_fuchsioides_leaf_RNA__00	BEG_Begonia_fuchsioides_leaf_RNA
BEG_Begonia_fuchsioides_leaf_RNA__01	BEG_Begonia_fuchsioides_leaf_RNA
BEG_Begonia_fuchsioides_leaf_RNA__02	BEG_Begonia_fuchsioides_leaf_RNA
BEG_Begonia_fuchsioides_leaf_RNA__03	BEG_Begonia_fuchsioides_leaf_RNA
BEG_Begonia_fuchsioides_leaf_RNA__04	BEG_Begonia_fuchsioides_leaf_RNA
BEG_Begonia_fuchsioides_leaf_RNA__05	BEG_Begonia_fuchsioides_leaf_RNA
BEG_Begonia_fuchsioides_root_RNA	BEG_Begonia_fuchsioides_root_RNA
BEG_Begonia_fuchsioides_root_RNA__00	BEG_Begonia_fuchsioides_root_RNA
BEG_Begonia_fuchsioides_root_RNA__01	BEG_Begonia_fuchsioides_root_RNA
BEG_Begonia_fuchsioides_root_RNA__02	BEG_Begonia_fuchsioides_root_RNA
BEG_Begonia_fuchsioides_root_RNA__03	BEG_Begonia_fuchsioides_root_RNA
BEG_Begonia_fuchsioides_root_RNA__04	BEG_Begonia_fuchsioides_root_RNA
BEG_Begonia_fuchsioides_root_RNA__05	BEG_Begonia_fuchsioides_root_RNA
BEG_Begonia_petasitifolia	BEG_Begonia_petasitifolia
BEG_Begonia_petasitifolia__00	BEG_Begonia_petasitifolia
BEG_Begonia_petasitifolia__01	BEG_Begonia_petasitifolia
BEG_Begonia_petasitifolia__02	BEG_Begonia_petasitifolia
BEG_Begonia_petasitifolia__03	BEG_Begonia_petasitifolia
BEG_Begonia_petasitifolia__04	BEG_Begonia_petasitifolia
BEG_Begonia_petasitifolia__05	BEG_Begonia_petasitifolia
BEG_Begonia_sp_RNA	BEG_Begonia_sp_RNA
BEG_Begonia_sp_RNA__00	BEG_Begonia_sp_RNA
BEG_Begonia_sp_RNA__01	BEG_Begonia_sp_RNA
BEG_Begonia_sp_RNA__02	BEG_Begonia_sp_RNA
BEG_Begonia_sp_RNA__03	BEG_Begonia_sp_RNA
BEG_Begonia_sp_RNA__04	BEG_Begonia_sp_RNA
BEG_Begonia_sp_RNA__05	BEG_Begonia_sp_RNA
BEG_Hillebrandia_sandwicensis	BEG_Hillebrandia_sandwicensis
BEG_Hillebrandia_sandwicensis__00	BEG_Hillebrandia_sandwicensis
BEG_Hillebrandia_sandwicensis__01	BEG_Hillebrandia_sandwicensis
BEG_Hillebrandia_sandwicensis__02	BEG_Hillebrandia_sandwicensis
BEKN__ref	BEKN__ref
BERS__ref	BERS__ref
BFJL__ref	BFJL__ref
BHYC__ref	BHYC__ref
BIDT__ref	BIDT__ref
BJKT__ref	BJKT__ref
BKQU__ref	BKQU__ref
BLVL__ref	BLVL__ref
BMSE__ref	BMSE__ref
BNDE__ref	BNDE__ref
BNTL__ref	BNTL__ref
BOLZ__ref	BOLZ__ref
BPKH__ref	BPKH__ref
BRUD__ref	BRUD__ref
BSEY__ref	BSEY__ref
BSVG__ref	BSVG__ref
BVOF__ref	BVOF__ref
BWRK__ref	BWRK__ref
BXAY__ref	BXAY__ref
BXBF__ref	BXBF__ref
BYNZ__ref	BYNZ__ref
BYPY__ref	BYPY__ref
BYQM__ref	BYQM__ref
BZDF__ref	BZDF__ref
CAQZ__ref	CAQZ__ref
CBJR__ref	CBJR__ref
CCID__ref	CCID__ref
CIAC__ref	CIAC__ref
CIEA__ref	CIEA__ref
CJGZ__ref	CJGZ__ref
CKDK__ref	CKDK__ref
CKKR__ref	CKKR__ref
CLMX__ref	CLMX__ref
CLRW__ref	CLRW__ref
CMCY__ref	CMCY__ref
CMFF__ref	CMFF__ref
CNTZ__ref	CNTZ__ref
COAQ__ref	COAQ__ref
COR_Coriaria_nepalensis	COR_Coriaria_nepalensis
COR_Coriaria_nepalensis_RNA	COR_Coriaria_nepalensis_RNA
COR_Coriaria_nepalensis_RNA__00	COR_Coriaria_nepalensis_RNA
COR_Coriaria_nepalensis_RNA__01	COR_Coriaria_nepalensis_RNA
COR_Coriaria_nepalensis_RNA__02	COR_Coriaria_nepalensis_RNA
COR_Coriaria_nepalensis_RNA__03	COR_Coriaria_nepalensis_RNA
COR_Coriaria_nepalensis__00	COR_Coriaria_nepalensis
COR_Coriaria_nepalensis__01	COR_Coriaria_nepalensis
COR_Coriaria_nepalensis__02	COR_Coriaria_nepalensis
COR_Coriaria_nepalensis__03	COR_Coriaria_nepalensis
COR_Coriaria_nepalensis__04	COR_Coriaria_nepalensis
COR_Coriaria_nepalensis__05	COR_Coriaria_nepalensis
CPKP__ref	CPKP__ref
CPLT__ref	CPLT__ref
CPOC__ref	CPOC__ref
CRNC__ref	CRNC__ref
CRN_Corynocarpus_cribbianus	CRN_Corynocarpus_cribbianus
CRN_Corynocarpus_cribbianus__00	CRN_Corynocarpus_cribbianus
CRN_Corynocarpus_cribbianus__01	CRN_Corynocarpus_cribbianus
CRN_Corynocarpus_cribbianus__02	CRN_Corynocarpus_cribbianus
CRN_Corynocarpus_cribbianus__03	CRN_Corynocarpus_cribbianus
CRN_Corynocarpus_cribbianus__04	CRN_Corynocarpus_cribbianus
CRN_Corynocarpus_cribbianus__05	CRN_Corynocarpus_cribbianus
CRN_Corynocarpus_laevigatus_HS5848_WGS	CRN_Corynocarpus_laevigatus_HS5848_WGS
CRN_Corynocarpus_laevigatus_HS5848_WGS__00	CRN_Corynocarpus_laevigatus_HS5848_WGS
CRN_Corynocarpus_laevigatus_HS5848_WGS__01	CRN_Corynocarpus_laevigatus_HS5848_WGS
CRN_Corynocarpus_laevigatus_HS5848_WGS__02	CRN_Corynocarpus_laevigatus_HS5848_WGS
CRN_Corynocarpus_laevigatus_HS5848_WGS__03	CRN_Corynocarpus_laevigatus_HS5848_WGS
CRN_Corynocarpus_laevigatus_HS5848_WGS__04	CRN_Corynocarpus_laevigatus_HS5848_WGS
CRN_Corynocarpus_laevigatus_HS5848_WGS__05	CRN_Corynocarpus_laevigatus_HS5848_WGS
CSSK__ref	CSSK__ref
CSUV__ref	CSUV__ref
CTSS__ref	CTSS__ref
CTYH__ref	CTYH__ref
CUC_Abobra_tenuifolia	CUC_Abobra_tenuifolia
CUC_Abobra_tenuifolia__00	CUC_Abobra_tenuifolia
CUC_Abobra_tenuifolia__01	CUC_Abobra_tenuifolia
CUC_Abobra_tenuifolia__02	CUC_Abobra_tenuifolia
CUC_Abobra_tenuifolia__03	CUC_Abobra_tenuifolia
CUC_Abobra_tenuifolia__04	CUC_Abobra_tenuifolia
CUC_Acanthosicyos_horridus	CUC_Acanthosicyos_horridus
CUC_Acanthosicyos_horridus__00	CUC_Acanthosicyos_horridus
CUC_Acanthosicyos_horridus__01	CUC_Acanthosicyos_horridus
CUC_Acanthosicyos_horridus__02	CUC_Acanthosicyos_horridus
CUC_Acanthosicyos_horridus__03	CUC_Acanthosicyos_horridus
CUC_Acanthosicyos_horridus__04	CUC_Acanthosicyos_horridus
CUC_Actinostemma_biglandulosum	CUC_Actinostemma_biglandulosum
CUC_Actinostemma_biglandulosum_RNA	CUC_Actinostemma_biglandulosum_RNA
CUC_Actinostemma_biglandulosum_RNA__00	CUC_Actinostemma_biglandulosum_RNA
CUC_Actinostemma_biglandulosum_RNA__01	CUC_Actinostemma_biglandulosum_RNA
CUC_Actinostemma_biglandulosum_RNA__02	CUC_Actinostemma_biglandulosum_RNA
CUC_Actinostemma_biglandulosum_RNA__03	CUC_Actinostemma_biglandulosum_RNA
CUC_Actinostemma_biglandulosum__00	CUC_Actinostemma_biglandulosum
CUC_Actinostemma_biglandulosum__01	CUC_Actinostemma_biglandulosum
CUC_Actinostemma_paniculatum_RNA	CUC_Actinostemma_paniculatum_RNA
CUC_Actinostemma_paniculatum_RNA__00	CUC_Actinostemma_paniculatum_RNA
CUC_Actinostemma_paniculatum_RNA__01	CUC_Actinostemma_paniculatum_RNA
CUC_Actinostemma_paniculatum_RNA__02	CUC_Actinostemma_paniculatum_RNA
CUC_Actinostemma_paniculatum_RNA__03	CUC_Actinostemma_paniculatum_RNA
CUC_Actinostemma_paniculatum_RNA__04	CUC_Actinostemma_paniculatum_RNA
CUC_Actinostemma_paniculatum_RNA__05	CUC_Actinostemma_paniculatum_RNA
CUC_Actinostemma_tenerum_RNA	CUC_Actinostemma_tenerum_RNA
CUC_Actinostemma_tenerum_RNA__00	CUC_Actinostemma_tenerum_RNA
CUC_Actinostemma_tenerum_RNA__01	CUC_Actinostemma_tenerum_RNA
CUC_Actinostemma_tenerum_RNA__02	CUC_Actinostemma_tenerum_RNA
CUC_Actinostemma_tenerum_RNA__03	CUC_Actinostemma_tenerum_RNA
CUC_Actinostemma_tenerum_RNA__04	CUC_Actinostemma_tenerum_RNA
CUC_Alsomitra_macrocarpa	CUC_Alsomitra_macrocarpa
CUC_Alsomitra_macrocarpa__00	CUC_Alsomitra_macrocarpa
CUC_Alsomitra_macrocarpa__01	CUC_Alsomitra_macrocarpa
CUC_Ampelosicyos_humblotii_1	CUC_Ampelosicyos_humblotii_1
CUC_Ampelosicyos_humblotii_1__00	CUC_Ampelosicyos_humblotii_1
CUC_Ampelosicyos_humblotii_1__01	CUC_Ampelosicyos_humblotii_1
CUC_Ampelosicyos_humblotii_1__02	CUC_Ampelosicyos_humblotii_1
CUC_Ampelosicyos_humblotii_1__03	CUC_Ampelosicyos_humblotii_1
CUC_Ampelosicyos_humblotii_1__04	CUC_Ampelosicyos_humblotii_1
CUC_Ampelosicyos_humblotii_1__05	CUC_Ampelosicyos_humblotii_1
CUC_Ampelosicyos_humblotii_2	CUC_Ampelosicyos_humblotii_2
CUC_Ampelosicyos_humblotii_2__00	CUC_Ampelosicyos_humblotii_2
CUC_Ampelosicyos_humblotii_2__01	CUC_Ampelosicyos_humblotii_2
CUC_Ampelosicyos_humblotii_2__02	CUC_Ampelosicyos_humblotii_2
CUC_Ampelosicyos_humblotii_2__03	CUC_Ampelosicyos_humblotii_2
CUC_Ampelosicyos_humblotii_2__04	CUC_Ampelosicyos_humblotii_2
CUC_Ampelosicyos_humblotii_SB12_GSK	CUC_Ampelosicyos_humblotii_SB12_GSK
CUC_Ampelosicyos_humblotii_SB12_GSK__00	CUC_Ampelosicyos_humblotii_SB12_GSK
CUC_Ampelosicyos_humblotii_SB12_GSK__01	CUC_Ampelosicyos_humblotii_SB12_GSK
CUC_Ampelosicyos_humblotii_SB12_GSK__02	CUC_Ampelosicyos_humblotii_SB12_GSK
CUC_Apodanthera_sp_HS5725_WGS	CUC_Apodanthera_sp_HS5725_WGS
CUC_Apodanthera_sp_HS5725_WGS__00	CUC_Apodanthera_sp_HS5725_WGS
CUC_Apodanthera_sp_HS5725_WGS__01	CUC_Apodanthera_sp_HS5725_WGS
CUC_Apodanthera_sp_HS5725_WGS__02	CUC_Apodanthera_sp_HS5725_WGS
CUC_Apodanthera_sp_HS5725_WGS__03	CUC_Apodanthera_sp_HS5725_WGS
CUC_Austrobryonia_argillicola	CUC_Austrobryonia_argillicola
CUC_Austrobryonia_argillicola__00	CUC_Austrobryonia_argillicola
CUC_Austrobryonia_argillicola__01	CUC_Austrobryonia_argillicola
CUC_Austrobryonia_argillicola__02	CUC_Austrobryonia_argillicola
CUC_Baijiania_taiwaniana_RNA	CUC_Baijiania_taiwaniana_RNA
CUC_Baijiania_taiwaniana_RNA__00	CUC_Baijiania_taiwaniana_RNA
CUC_Baijiania_taiwaniana_RNA__01	CUC_Baijiania_taiwaniana_RNA
CUC_Baijiania_taiwaniana_RNA__02	CUC_Baijiania_taiwaniana_RNA
CUC_Baijiania_yunnanensis	CUC_Baijiania_yunnanensis
CUC_Baijiania_yunnanensis_HS2656_GSK	CUC_Baijiania_yunnanensis_HS2656_GSK
CUC_Baijiania_yunnanensis_HS2656_GSK__00	CUC_Baijiania_yunnanensis_HS2656_GSK
CUC_Baijiania_yunnanensis_HS2656_GSK__01	CUC_Baijiania_yunnanensis_HS2656_GSK
CUC_Baijiania_yunnanensis_HS2656_GSK__02	CUC_Baijiania_yunnanensis_HS2656_GSK
CUC_Baijiania_yunnanensis_HS2656_GSK__03	CUC_Baijiania_yunnanensis_HS2656_GSK
CUC_Baijiania_yunnanensis_HS2656_GSK__04	CUC_Baijiania_yunnanensis_HS2656_GSK
CUC_Baijiania_yunnanensis_HS2656_GSK__05	CUC_Baijiania_yunnanensis_HS2656_GSK
CUC_Baijiania_yunnanensis_RNA	CUC_Baijiania_yunnanensis_RNA
CUC_Baijiania_yunnanensis_RNA__00	CUC_Baijiania_yunnanensis_RNA
CUC_Baijiania_yunnanensis_RNA__01	CUC_Baijiania_yunnanensis_RNA
CUC_Baijiania_yunnanensis_RNA__02	CUC_Baijiania_yunnanensis_RNA
CUC_Baijiania_yunnanensis_RNA__03	CUC_Baijiania_yunnanensis_RNA
CUC_Baijiania_yunnanensis_RNA__04	CUC_Baijiania_yunnanensis_RNA
CUC_Baijiania_yunnanensis_RNA__05	CUC_Baijiania_yunnanensis_RNA
CUC_Baijiania_yunnanensis__00	CUC_Baijiania_yunnanensis
CUC_Baijiania_yunnanensis__01	CUC_Baijiania_yunnanensis
CUC_Baijiania_yunnanensis__02	CUC_Baijiania_yunnanensis
CUC_Baijiania_yunnanensis__03	CUC_Baijiania_yunnanensis
CUC_Baijiania_yunnanensis__04	CUC_Baijiania_yunnanensis
CUC_Baijiania_yunnanensis__05	CUC_Baijiania_yunnanensis
CUC_Bambekea_racemosa_HS5726_WGS	CUC_Bambekea_racemosa_HS5726_WGS
CUC_Bambekea_racemosa_HS5726_WGS__00	CUC_Bambekea_racemosa_HS5726_WGS
CUC_Bambekea_racemosa_HS5726_WGS__01	CUC_Bambekea_racemosa_HS5726_WGS
CUC_Bambekea_racemosa_HS5726_WGS__02	CUC_Bambekea_racemosa_HS5726_WGS
CUC_Bambekea_racemosa_HS5726_WGS__03	CUC_Bambekea_racemosa_HS5726_WGS
CUC_Bayabusua_clarkei	CUC_Bayabusua_clarkei
CUC_Bayabusua_clarkei__00	CUC_Bayabusua_clarkei
CUC_Bayabusua_clarkei__01	CUC_Bayabusua_clarkei
CUC_Bayabusua_clarkei__02	CUC_Bayabusua_clarkei
CUC_Bayabusua_clarkei__03	CUC_Bayabusua_clarkei
CUC_Bayabusua_clarkei__04	CUC_Bayabusua_clarkei
CUC_Bayabusua_clarkei__05	CUC_Bayabusua_clarkei
CUC_Benincasa_hispida	CUC_Benincasa_hispida
CUC_Benincasa_hispida_RNA	CUC_Benincasa_hispida_RNA
CUC_Benincasa_hispida_RNA__00	CUC_Benincasa_hispida_RNA
CUC_Benincasa_hispida_RNA__01	CUC_Benincasa_hispida_RNA
CUC_Benincasa_hispida_RNA__02	CUC_Benincasa_hispida_RNA
CUC_Benincasa_hispida_RNA__03	CUC_Benincasa_hispida_RNA
CUC_Benincasa_hispida_RNA__04	CUC_Benincasa_hispida_RNA
CUC_Benincasa_hispida__00	CUC_Benincasa_hispida
CUC_Benincasa_hispida__01	CUC_Benincasa_hispida
CUC_Benincasa_hispida__02	CUC_Benincasa_hispida
CUC_Benincasa_hispida__03	CUC_Benincasa_hispida
CUC_Blastania_cerasiformis	CUC_Blastania_cerasiformis
CUC_Blastania_cerasiformis__00	CUC_Blastania_cerasiformis
CUC_Blastania_cerasiformis__01	CUC_Blastania_cerasiformis
CUC_Blastania_cerasiformis__02	CUC_Blastania_cerasiformis
CUC_Blastania_cerasiformis__03	CUC_Blastania_cerasiformis
CUC_Borneosicyos_simplex	CUC_Borneosicyos_simplex
CUC_Borneosicyos_simplex__00	CUC_Borneosicyos_simplex
CUC_Borneosicyos_simplex__01	CUC_Borneosicyos_simplex
CUC_Borneosicyos_simplex__02	CUC_Borneosicyos_simplex
CUC_Borneosicyos_simplex__03	CUC_Borneosicyos_simplex
CUC_Borneosicyos_simplex__04	CUC_Borneosicyos_simplex
CUC_Bryonia_dioica_GSK	CUC_Bryonia_dioica_GSK
CUC_Bryonia_dioica_GSK__00	CUC_Bryonia_dioica_GSK
CUC_Bryonia_dioica_GSK__01	CUC_Bryonia_dioica_GSK
CUC_Bryonia_dioica_RNA	CUC_Bryonia_dioica_RNA
CUC_Bryonia_dioica_RNA__00	CUC_Bryonia_dioica_RNA
CUC_Bryonia_dioica_RNA__01	CUC_Bryonia_dioica_RNA
CUC_Bryonia_dioica_RNA__02	CUC_Bryonia_dioica_RNA
CUC_Bryonia_dioica_RNA__03	CUC_Bryonia_dioica_RNA
CUC_Bryonia_marmorata	CUC_Bryonia_marmorata
CUC_Bryonia_marmorata_SB24_GSK	CUC_Bryonia_marmorata_SB24_GSK
CUC_Bryonia_marmorata_SB24_GSK__00	CUC_Bryonia_marmorata_SB24_GSK
CUC_Bryonia_marmorata_SB24_GSK__01	CUC_Bryonia_marmorata_SB24_GSK
CUC_Bryonia_marmorata_SB24_GSK__02	CUC_Bryonia_marmorata_SB24_GSK
CUC_Bryonia_marmorata__00	CUC_Bryonia_marmorata
CUC_Bryonia_marmorata__01	CUC_Bryonia_marmorata
CUC_Bryonia_marmorata__02	CUC_Bryonia_marmorata
CUC_Bryonia_marmorata__03	CUC_Bryonia_marmorata
CUC_Bryonia_marmorata__04	CUC_Bryonia_marmorata
CUC_Bryonia_marmorata__05	CUC_Bryonia_marmorata
CUC_Calycophysum_brevipes	CUC_Calycophysum_brevipes
CUC_Calycophysum_brevipes__00	CUC_Calycophysum_brevipes
CUC_Calycophysum_brevipes__01	CUC_Calycophysum_brevipes
CUC_Calycophysum_brevipes__02	CUC_Calycophysum_brevipes
CUC_Calycophysum_brevipes__03	CUC_Calycophysum_brevipes
CUC_Calycophysum_brevipes__04	CUC_Calycophysum_brevipes
CUC_Cayaponia_cordata_HM3711_RNA	CUC_Cayaponia_cordata_HM3711_RNA
CUC_Cayaponia_cordata_HM3711_RNA__00	CUC_Cayaponia_cordata_HM3711_RNA
CUC_Cayaponia_cordata_HM3711_RNA__01	CUC_Cayaponia_cordata_HM3711_RNA
CUC_Cayaponia_cordata_HM3711_RNA__02	CUC_Cayaponia_cordata_HM3711_RNA
CUC_Cayaponia_cordata_HM3711_RNA__03	CUC_Cayaponia_cordata_HM3711_RNA
CUC_Cayaponia_cordata_HM3711_RNA__04	CUC_Cayaponia_cordata_HM3711_RNA
CUC_Cayaponia_cordata_HM3711_RNA__05	CUC_Cayaponia_cordata_HM3711_RNA
CUC_Cayaponia_domingensis	CUC_Cayaponia_domingensis
CUC_Cayaponia_domingensis__00	CUC_Cayaponia_domingensis
CUC_Cayaponia_domingensis__01	CUC_Cayaponia_domingensis
CUC_Cayaponia_domingensis__02	CUC_Cayaponia_domingensis
CUC_Cayaponia_domingensis__03	CUC_Cayaponia_domingensis
CUC_Cayaponia_domingensis__04	CUC_Cayaponia_domingensis
CUC_Cayaponia_domingensis__05	CUC_Cayaponia_domingensis
CUC_Cayaponia_racemosa_RNA	CUC_Cayaponia_racemosa_RNA
CUC_Cayaponia_racemosa_RNA__00	CUC_Cayaponia_racemosa_RNA
CUC_Cayaponia_racemosa_RNA__01	CUC_Cayaponia_racemosa_RNA
CUC_Cayaponia_racemosa_RNA__02	CUC_Cayaponia_racemosa_RNA
CUC_Cayaponia_racemosa_RNA__03	CUC_Cayaponia_racemosa_RNA
CUC_Cayaponia_racemosa_RNA__04	CUC_Cayaponia_racemosa_RNA
CUC_Cayaponia_racemosa_RNA__05	CUC_Cayaponia_racemosa_RNA
CUC_Cayaponia_selysioides	CUC_Cayaponia_selysioides
CUC_Cayaponia_selysioides__00	CUC_Cayaponia_selysioides
CUC_Cayaponia_selysioides__01	CUC_Cayaponia_selysioides
CUC_Cayaponia_selysioides__02	CUC_Cayaponia_selysioides
CUC_Cayaponia_selysioides__03	CUC_Cayaponia_selysioides
CUC_Cayaponia_selysioides__04	CUC_Cayaponia_selysioides
CUC_Cayaponia_selysioides__05	CUC_Cayaponia_selysioides
CUC_Cephalopentandra_ecirrhosa	CUC_Cephalopentandra_ecirrhosa
CUC_Cephalopentandra_ecirrhosa_RNA	CUC_Cephalopentandra_ecirrhosa_RNA
CUC_Cephalopentandra_ecirrhosa_RNA__00	CUC_Cephalopentandra_ecirrhosa_RNA
CUC_Cephalopentandra_ecirrhosa_RNA__01	CUC_Cephalopentandra_ecirrhosa_RNA
CUC_Cephalopentandra_ecirrhosa_RNA__02	CUC_Cephalopentandra_ecirrhosa_RNA
CUC_Cephalopentandra_ecirrhosa_RNA__03	CUC_Cephalopentandra_ecirrhosa_RNA
CUC_Cephalopentandra_ecirrhosa_RNA__04	CUC_Cephalopentandra_ecirrhosa_RNA
CUC_Cephalopentandra_ecirrhosa_RNA__05	CUC_Cephalopentandra_ecirrhosa_RNA
CUC_Cephalopentandra_ecirrhosa__00	CUC_Cephalopentandra_ecirrhosa
CUC_Cephalopentandra_ecirrhosa__01	CUC_Cephalopentandra_ecirrhosa
CUC_Cephalopentandra_ecirrhosa__02	CUC_Cephalopentandra_ecirrhosa
CUC_Cephalopentandra_ecirrhosa__03	CUC_Cephalopentandra_ecirrhosa
CUC_Cephalopentandra_ecirrhosa__04	CUC_Cephalopentandra_ecirrhosa
CUC_Cephalopentandra_ecirrhosa__05	CUC_Cephalopentandra_ecirrhosa
CUC_Ceratosanthes_palmata	CUC_Ceratosanthes_palmata
CUC_Ceratosanthes_palmata__00	CUC_Ceratosanthes_palmata
CUC_Ceratosanthes_palmata__01	CUC_Ceratosanthes_palmata
CUC_Ceratosanthes_palmata__02	CUC_Ceratosanthes_palmata
CUC_Ceratosanthes_palmata__03	CUC_Ceratosanthes_palmata
CUC_Ceratosanthes_palmata__04	CUC_Ceratosanthes_palmata
CUC_Ceratosanthes_palmata__05	CUC_Ceratosanthes_palmata
CUC_Cionosicys_macranthus	CUC_Cionosicys_macranthus
CUC_Cionosicys_macranthus_HS2657_GSK	CUC_Cionosicys_macranthus_HS2657_GSK
CUC_Cionosicys_macranthus_HS2657_GSK__00	CUC_Cionosicys_macranthus_HS2657_GSK
CUC_Cionosicys_macranthus_HS2657_GSK__01	CUC_Cionosicys_macranthus_HS2657_GSK
CUC_Cionosicys_macranthus_HS2657_GSK__02	CUC_Cionosicys_macranthus_HS2657_GSK
CUC_Cionosicys_macranthus_RNA	CUC_Cionosicys_macranthus_RNA
CUC_Cionosicys_macranthus_RNA__00	CUC_Cionosicys_macranthus_RNA
CUC_Cionosicys_macranthus_RNA__01	CUC_Cionosicys_macranthus_RNA
CUC_Cionosicys_macranthus_RNA__02	CUC_Cionosicys_macranthus_RNA
CUC_Cionosicys_macranthus_RNA__03	CUC_Cionosicys_macranthus_RNA
CUC_Cionosicys_macranthus_RNA__04	CUC_Cionosicys_macranthus_RNA
CUC_Cionosicys_macranthus_RNA__05	CUC_Cionosicys_macranthus_RNA
CUC_Cionosicys_macranthus__00	CUC_Cionosicys_macranthus
CUC_Cionosicys_macranthus__01	CUC_Cionosicys_macranthus
CUC_Cionosicys_macranthus__02	CUC_Cionosicys_macranthus
CUC_Citrullus_amarus_WGS	CUC_Citrullus_amarus_WGS
CUC_Citrullus_amarus_WGS__00	CUC_Citrullus_amarus_WGS
CUC_Citrullus_amarus_WGS__01	CUC_Citrullus_amarus_WGS
CUC_Citrullus_amarus_WGS__02	CUC_Citrullus_amarus_WGS
CUC_Citrullus_amarus_WGS__03	CUC_Citrullus_amarus_WGS
CUC_Citrullus_colocynthis_WGS	CUC_Citrullus_colocynthis_WGS
CUC_Citrullus_colocynthis_WGS__00	CUC_Citrullus_colocynthis_WGS
CUC_Citrullus_colocynthis_WGS__01	CUC_Citrullus_colocynthis_WGS
CUC_Citrullus_colocynthis_WGS__02	CUC_Citrullus_colocynthis_WGS
CUC_Citrullus_ecirrhosus	CUC_Citrullus_ecirrhosus
CUC_Citrullus_ecirrhosus_WGS	CUC_Citrullus_ecirrhosus_WGS
CUC_Citrullus_ecirrhosus_WGS__00	CUC_Citrullus_ecirrhosus_WGS
CUC_Citrullus_ecirrhosus_WGS__01	CUC_Citrullus_ecirrhosus_WGS
CUC_Citrullus_ecirrhosus_WGS__02	CUC_Citrullus_ecirrhosus_WGS
CUC_Citrullus_ecirrhosus_WGS__03	CUC_Citrullus_ecirrhosus_WGS
CUC_Citrullus_ecirrhosus__00	CUC_Citrullus_ecirrhosus
CUC_Citrullus_ecirrhosus__01	CUC_Citrullus_ecirrhosus
CUC_Citrullus_ecirrhosus__02	CUC_Citrullus_ecirrhosus
CUC_Citrullus_lanatus_1_WGS	CUC_Citrullus_lanatus_1_WGS
CUC_Citrullus_lanatus_1_WGS__00	CUC_Citrullus_lanatus_1_WGS
CUC_Citrullus_lanatus_1_WGS__01	CUC_Citrullus_lanatus_1_WGS
CUC_Citrullus_lanatus_2_WGS	CUC_Citrullus_lanatus_2_WGS
CUC_Citrullus_lanatus_2_WGS__00	CUC_Citrullus_lanatus_2_WGS
CUC_Citrullus_lanatus_2_WGS__01	CUC_Citrullus_lanatus_2_WGS
CUC_Citrullus_lanatus_3_WGS	CUC_Citrullus_lanatus_3_WGS
CUC_Citrullus_lanatus_3_WGS__00	CUC_Citrullus_lanatus_3_WGS
CUC_Citrullus_lanatus_3_WGS__01	CUC_Citrullus_lanatus_3_WGS
CUC_Citrullus_mucosospermus_WGS	CUC_Citrullus_mucosospermus_WGS
CUC_Citrullus_mucosospermus_WGS__00	CUC_Citrullus_mucosospermus_WGS
CUC_Citrullus_mucosospermus_WGS__01	CUC_Citrullus_mucosospermus_WGS
CUC_Citrullus_mucosospermus_WGS__02	CUC_Citrullus_mucosospermus_WGS
CUC_Citrullus_naudinianus_WGS	CUC_Citrullus_naudinianus_WGS
CUC_Citrullus_naudinianus_WGS__00	CUC_Citrullus_naudinianus_WGS
CUC_Citrullus_naudinianus_WGS__01	CUC_Citrullus_naudinianus_WGS
CUC_Citrullus_naudinianus_WGS__02	CUC_Citrullus_naudinianus_WGS
CUC_Citrullus_naudinianus_WGS__03	CUC_Citrullus_naudinianus_WGS
CUC_Citrullus_naudinianus_WGS__04	CUC_Citrullus_naudinianus_WGS
CUC_Citrullus_naudinianus_WGS__05	CUC_Citrullus_naudinianus_WGS
CUC_Citrullus_rehmii_WGS	CUC_Citrullus_rehmii_WGS
CUC_Citrullus_rehmii_WGS__00	CUC_Citrullus_rehmii_WGS
CUC_Citrullus_rehmii_WGS__01	CUC_Citrullus_rehmii_WGS
CUC_Citrullus_rehmii_WGS__02	CUC_Citrullus_rehmii_WGS
CUC_Coccinia_grandis_RNA	CUC_Coccinia_grandis_RNA
CUC_Coccinia_grandis_RNA__00	CUC_Coccinia_grandis_RNA
CUC_Coccinia_grandis_RNA__01	CUC_Coccinia_grandis_RNA
CUC_Coccinia_grandis_RNA__02	CUC_Coccinia_grandis_RNA
CUC_Coccinia_grandis_RNA__03	CUC_Coccinia_grandis_RNA
CUC_Coccinia_grandis_RNA__04	CUC_Coccinia_grandis_RNA
CUC_Coccinia_grandis_RNA__05	CUC_Coccinia_grandis_RNA
CUC_Coccinia_grandis_XWB13686_RNA	CUC_Coccinia_grandis_XWB13686_RNA
CUC_Coccinia_grandis_XWB13686_RNA__00	CUC_Coccinia_grandis_XWB13686_RNA
CUC_Coccinia_grandis_XWB13686_RNA__01	CUC_Coccinia_grandis_XWB13686_RNA
CUC_Coccinia_grandis_XWB13686_RNA__02	CUC_Coccinia_grandis_XWB13686_RNA
CUC_Coccinia_grandis_XWB13686_RNA__03	CUC_Coccinia_grandis_XWB13686_RNA
CUC_Coccinia_grandis_XWB13686_RNA__04	CUC_Coccinia_grandis_XWB13686_RNA
CUC_Coccinia_grandis_XWB13686_RNA__05	CUC_Coccinia_grandis_XWB13686_RNA
CUC_Coccinia_rehmannii_GJ090_RNA	CUC_Coccinia_rehmannii_GJ090_RNA
CUC_Coccinia_rehmannii_GJ090_RNA__00	CUC_Coccinia_rehmannii_GJ090_RNA
CUC_Coccinia_rehmannii_GJ090_RNA__01	CUC_Coccinia_rehmannii_GJ090_RNA
CUC_Coccinia_rehmannii_GJ090_RNA__02	CUC_Coccinia_rehmannii_GJ090_RNA
CUC_Coccinia_rehmannii_GJ090_RNA__03	CUC_Coccinia_rehmannii_GJ090_RNA
CUC_Coccinia_rehmannii_GJ090_RNA__04	CUC_Coccinia_rehmannii_GJ090_RNA
CUC_Coccinia_rehmannii_GJ090_RNA__05	CUC_Coccinia_rehmannii_GJ090_RNA
CUC_Coccinia_sessilifolia	CUC_Coccinia_sessilifolia
CUC_Coccinia_sessilifolia__00	CUC_Coccinia_sessilifolia
CUC_Coccinia_sessilifolia__01	CUC_Coccinia_sessilifolia
CUC_Coccinia_sessilifolia__02	CUC_Coccinia_sessilifolia
CUC_Coccinia_sessilifolia__03	CUC_Coccinia_sessilifolia
CUC_Coccinia_sessilifolia__04	CUC_Coccinia_sessilifolia
CUC_Coccinia_trilobata_RNA	CUC_Coccinia_trilobata_RNA
CUC_Coccinia_trilobata_RNA__00	CUC_Coccinia_trilobata_RNA
CUC_Coccinia_trilobata_RNA__01	CUC_Coccinia_trilobata_RNA
CUC_Coccinia_trilobata_RNA__02	CUC_Coccinia_trilobata_RNA
CUC_Coccinia_trilobata_RNA__03	CUC_Coccinia_trilobata_RNA
CUC_Coccinia_trilobata_RNA__04	CUC_Coccinia_trilobata_RNA
CUC_Coccinia_trilobata_RNA__05	CUC_Coccinia_trilobata_RNA
CUC_Cogniauxia_podolaena	CUC_Cogniauxia_podolaena
CUC_Cogniauxia_podolaena__00	CUC_Cogniauxia_podolaena
CUC_Cogniauxia_podolaena__01	CUC_Cogniauxia_podolaena
CUC_Cogniauxia_podolaena__02	CUC_Cogniauxia_podolaena
CUC_Cogniauxia_podolaena__03	CUC_Cogniauxia_podolaena
CUC_Cogniauxia_podolaena__04	CUC_Cogniauxia_podolaena
CUC_Cogniauxia_podolaena__05	CUC_Cogniauxia_podolaena
CUC_Corallocarpus_boehmii_SB19_GSK	CUC_Corallocarpus_boehmii_SB19_GSK
CUC_Corallocarpus_boehmii_SB19_GSK__00	CUC_Corallocarpus_boehmii_SB19_GSK
CUC_Corallocarpus_boehmii_SB19_GSK__01	CUC_Corallocarpus_boehmii_SB19_GSK
CUC_Corallocarpus_glomeruliflorus_RNA	CUC_Corallocarpus_glomeruliflorus_RNA
CUC_Corallocarpus_glomeruliflorus_RNA__00	CUC_Corallocarpus_glomeruliflorus_RNA
CUC_Corallocarpus_glomeruliflorus_RNA__01	CUC_Corallocarpus_glomeruliflorus_RNA
CUC_Corallocarpus_glomeruliflorus_RNA__02	CUC_Corallocarpus_glomeruliflorus_RNA
CUC_Corallocarpus_glomeruliflorus_RNA__03	CUC_Corallocarpus_glomeruliflorus_RNA
CUC_Corallocarpus_glomeruliflorus_RNA__04	CUC_Corallocarpus_glomeruliflorus_RNA
CUC_Corallocarpus_welwitschii	CUC_Corallocarpus_welwitschii
CUC_Corallocarpus_welwitschii__00	CUC_Corallocarpus_welwitschii
CUC_Corallocarpus_welwitschii__01	CUC_Corallocarpus_welwitschii
CUC_Corallocarpus_welwitschii__02	CUC_Corallocarpus_welwitschii
CUC_Corallocarpus_welwitschii__03	CUC_Corallocarpus_welwitschii
CUC_Corallocarpus_welwitschii__04	CUC_Corallocarpus_welwitschii
CUC_Corallocarpus_welwitschii__05	CUC_Corallocarpus_welwitschii
CUC_Cucumis_anguria	CUC_Cucumis_anguria
CUC_Cucumis_anguria_WGS	CUC_Cucumis_anguria_WGS
CUC_Cucumis_anguria_WGS__00	CUC_Cucumis_anguria_WGS
CUC_Cucumis_anguria_WGS__01	CUC_Cucumis_anguria_WGS
CUC_Cucumis_anguria_WGS__02	CUC_Cucumis_anguria_WGS
CUC_Cucumis_anguria__00	CUC_Cucumis_anguria
CUC_Cucumis_anguria__01	CUC_Cucumis_anguria
CUC_Cucumis_anguria__02	CUC_Cucumis_anguria
CUC_Cucumis_anguria__03	CUC_Cucumis_anguria
CUC_Cucumis_dipsaceus_WGS	CUC_Cucumis_dipsaceus_WGS
CUC_Cucumis_dipsaceus_WGS__00	CUC_Cucumis_dipsaceus_WGS
CUC_Cucumis_dipsaceus_WGS__01	CUC_Cucumis_dipsaceus_WGS
CUC_Cucumis_dipsaceus_WGS__02	CUC_Cucumis_dipsaceus_WGS
CUC_Cucumis_dipsaceus_WGS__03	CUC_Cucumis_dipsaceus_WGS
CUC_Cucumis_dipsaceus_WGS__04	CUC_Cucumis_dipsaceus_WGS
CUC_Cucumis_dipsaceus_WGS__05	CUC_Cucumis_dipsaceus_WGS
CUC_Cucumis_ficifolius_WGS	CUC_Cucumis_ficifolius_WGS
CUC_Cucumis_ficifolius_WGS__00	CUC_Cucumis_ficifolius_WGS
CUC_Cucumis_ficifolius_WGS__01	CUC_Cucumis_ficifolius_WGS
CUC_Cucumis_ficifolius_WGS__02	CUC_Cucumis_ficifolius_WGS
CUC_Cucumis_ficifolius_WGS__03	CUC_Cucumis_ficifolius_WGS
CUC_Cucumis_ficifolius_WGS__04	CUC_Cucumis_ficifolius_WGS
CUC_Cucumis_ficifolius_WGS__05	CUC_Cucumis_ficifolius_WGS
CUC_Cucumis_hystrix_RNA	CUC_Cucumis_hystrix_RNA
CUC_Cucumis_hystrix_RNA__00	CUC_Cucumis_hystrix_RNA
CUC_Cucumis_hystrix_RNA__01	CUC_Cucumis_hystrix_RNA
CUC_Cucumis_hystrix_RNA__02	CUC_Cucumis_hystrix_RNA
CUC_Cucumis_hystrix_RNA__03	CUC_Cucumis_hystrix_RNA
CUC_Cucumis_hystrix_RNA__04	CUC_Cucumis_hystrix_RNA
CUC_Cucumis_hystrix_RNA__05	CUC_Cucumis_hystrix_RNA
CUC_Cucumis_hystrix_WGS	CUC_Cucumis_hystrix_WGS
CUC_Cucumis_hystrix_WGS__00	CUC_Cucumis_hystrix_WGS
CUC_Cucumis_hystrix_WGS__01	CUC_Cucumis_hystrix_WGS
CUC_Cucumis_hystrix_WGS__02	CUC_Cucumis_hystrix_WGS
CUC_Cucumis_hystrix_WGS__03	CUC_Cucumis_hystrix_WGS
CUC_Cucumis_hystrix_WGS__04	CUC_Cucumis_hystrix_WGS
CUC_Cucumis_hystrix_WGS__05	CUC_Cucumis_hystrix_WGS
CUC_Cucumis_maderaspatanus_RNA	CUC_Cucumis_maderaspatanus_RNA
CUC_Cucumis_maderaspatanus_RNA__00	CUC_Cucumis_maderaspatanus_RNA
CUC_Cucumis_maderaspatanus_RNA__01	CUC_Cucumis_maderaspatanus_RNA
CUC_Cucumis_maderaspatanus_RNA__02	CUC_Cucumis_maderaspatanus_RNA
CUC_Cucumis_maderaspatanus_RNA__03	CUC_Cucumis_maderaspatanus_RNA
CUC_Cucumis_maderaspatanus_RNA__04	CUC_Cucumis_maderaspatanus_RNA
CUC_Cucumis_melo_RNA	CUC_Cucumis_melo_RNA
CUC_Cucumis_melo_RNA__00	CUC_Cucumis_melo_RNA
CUC_Cucumis_melo_RNA__01	CUC_Cucumis_melo_RNA
CUC_Cucumis_melo_RNA__02	CUC_Cucumis_melo_RNA
CUC_Cucumis_melo_RNA__03	CUC_Cucumis_melo_RNA
CUC_Cucumis_melo_RNA__04	CUC_Cucumis_melo_RNA
CUC_Cucumis_melo_subsp_agrestis_WGS	CUC_Cucumis_melo_subsp_agrestis_WGS
CUC_Cucumis_melo_subsp_agrestis_WGS__00	CUC_Cucumis_melo_subsp_agrestis_WGS
CUC_Cucumis_melo_subsp_agrestis_WGS__01	CUC_Cucumis_melo_subsp_agrestis_WGS
CUC_Cucumis_melo_subsp_agrestis_WGS__02	CUC_Cucumis_melo_subsp_agrestis_WGS
CUC_Cucumis_melo_subsp_agrestis_WGS__03	CUC_Cucumis_melo_subsp_agrestis_WGS
CUC_Cucumis_melo_subsp_agrestis_WGS__04	CUC_Cucumis_melo_subsp_agrestis_WGS
CUC_Cucumis_melo_subsp_agrestis_WGS__05	CUC_Cucumis_melo_subsp_agrestis_WGS
CUC_Cucumis_melo_subsp_melo_WGS	CUC_Cucumis_melo_subsp_melo_WGS
CUC_Cucumis_melo_subsp_melo_WGS__00	CUC_Cucumis_melo_subsp_melo_WGS
CUC_Cucumis_melo_subsp_melo_WGS__01	CUC_Cucumis_melo_subsp_melo_WGS
CUC_Cucumis_melo_subsp_melo_WGS__02	CUC_Cucumis_melo_subsp_melo_WGS
CUC_Cucumis_melo_subsp_melo_WGS__03	CUC_Cucumis_melo_subsp_melo_WGS
CUC_Cucumis_melo_subsp_melo_WGS__04	CUC_Cucumis_melo_subsp_melo_WGS
CUC_Cucumis_metuliferus_1_RNA	CUC_Cucumis_metuliferus_1_RNA
CUC_Cucumis_metuliferus_1_RNA__00	CUC_Cucumis_metuliferus_1_RNA
CUC_Cucumis_metuliferus_1_RNA__01	CUC_Cucumis_metuliferus_1_RNA
CUC_Cucumis_metuliferus_1_RNA__02	CUC_Cucumis_metuliferus_1_RNA
CUC_Cucumis_metuliferus_1_RNA__03	CUC_Cucumis_metuliferus_1_RNA
CUC_Cucumis_metuliferus_1_RNA__04	CUC_Cucumis_metuliferus_1_RNA
CUC_Cucumis_metuliferus_2_RNA	CUC_Cucumis_metuliferus_2_RNA
CUC_Cucumis_metuliferus_2_RNA__00	CUC_Cucumis_metuliferus_2_RNA
CUC_Cucumis_metuliferus_2_RNA__01	CUC_Cucumis_metuliferus_2_RNA
CUC_Cucumis_metuliferus_2_RNA__02	CUC_Cucumis_metuliferus_2_RNA
CUC_Cucumis_myriocarpus_WGS	CUC_Cucumis_myriocarpus_WGS
CUC_Cucumis_myriocarpus_WGS__00	CUC_Cucumis_myriocarpus_WGS
CUC_Cucumis_myriocarpus_WGS__01	CUC_Cucumis_myriocarpus_WGS
CUC_Cucumis_myriocarpus_WGS__02	CUC_Cucumis_myriocarpus_WGS
CUC_Cucumis_myriocarpus_WGS__03	CUC_Cucumis_myriocarpus_WGS
CUC_Cucumis_omissus_HS5733_WGS	CUC_Cucumis_omissus_HS5733_WGS
CUC_Cucumis_omissus_HS5733_WGS__00	CUC_Cucumis_omissus_HS5733_WGS
CUC_Cucumis_omissus_HS5733_WGS__01	CUC_Cucumis_omissus_HS5733_WGS
CUC_Cucumis_omissus_HS5733_WGS__02	CUC_Cucumis_omissus_HS5733_WGS
CUC_Cucumis_omissus_HS5733_WGS__03	CUC_Cucumis_omissus_HS5733_WGS
CUC_Cucumis_prophetarum	CUC_Cucumis_prophetarum
CUC_Cucumis_prophetarum_WGS	CUC_Cucumis_prophetarum_WGS
CUC_Cucumis_prophetarum_WGS__00	CUC_Cucumis_prophetarum_WGS
CUC_Cucumis_prophetarum_WGS__01	CUC_Cucumis_prophetarum_WGS
CUC_Cucumis_prophetarum_WGS__02	CUC_Cucumis_prophetarum_WGS
CUC_Cucumis_prophetarum_WGS__03	CUC_Cucumis_prophetarum_WGS
CUC_Cucumis_prophetarum_WGS__04	CUC_Cucumis_prophetarum_WGS
CUC_Cucumis_prophetarum_WGS__05	CUC_Cucumis_prophetarum_WGS
CUC_Cucumis_prophetarum__00	CUC_Cucumis_prophetarum
CUC_Cucumis_prophetarum__01	CUC_Cucumis_prophetarum
CUC_Cucumis_prophetarum__02	CUC_Cucumis_prophetarum
CUC_Cucumis_prophetarum__03	CUC_Cucumis_prophetarum
CUC_Cucumis_prophetarum__04	CUC_Cucumis_prophetarum
CUC_Cucumis_prophetarum__05	CUC_Cucumis_prophetarum
CUC_Cucumis_rigidus	CUC_Cucumis_rigidus
CUC_Cucumis_rigidus__00	CUC_Cucumis_rigidus
CUC_Cucumis_rigidus__01	CUC_Cucumis_rigidus
CUC_Cucumis_rigidus__02	CUC_Cucumis_rigidus
CUC_Cucumis_rigidus__03	CUC_Cucumis_rigidus
CUC_Cucumis_rigidus__04	CUC_Cucumis_rigidus
CUC_Cucumis_rigidus__05	CUC_Cucumis_rigidus
CUC_Cucumis_sativus_var_hardwickii_RNA	CUC_Cucumis_sativus_var_hardwickii_RNA
CUC_Cucumis_sativus_var_hardwickii_RNA__00	CUC_Cucumis_sativus_var_hardwickii_RNA
CUC_Cucumis_sativus_var_hardwickii_RNA__01	CUC_Cucumis_sativus_var_hardwickii_RNA
CUC_Cucumis_sativus_var_hardwickii_RNA__02	CUC_Cucumis_sativus_var_hardwickii_RNA
CUC_Cucumis_sativus_var_hardwickii_RNA__03	CUC_Cucumis_sativus_var_hardwickii_RNA
CUC_Cucumis_sativus_var_sativus_RNA	CUC_Cucumis_sativus_var_sativus_RNA
CUC_Cucumis_sativus_var_sativus_RNA__00	CUC_Cucumis_sativus_var_sativus_RNA
CUC_Cucumis_sativus_var_sativus_RNA__01	CUC_Cucumis_sativus_var_sativus_RNA
CUC_Cucumis_sativus_var_sativus_RNA__02	CUC_Cucumis_sativus_var_sativus_RNA
CUC_Cucumis_sativus_var_sativus_RNA__03	CUC_Cucumis_sativus_var_sativus_RNA
CUC_Cucumis_sativus_var_sativus_RNA__04	CUC_Cucumis_sativus_var_sativus_RNA
CUC_Cucumis_sativus_var_sativus_RNA__05	CUC_Cucumis_sativus_var_sativus_RNA
CUC_Cucumis_zeyherii_WGS	CUC_Cucumis_zeyherii_WGS
CUC_Cucumis_zeyherii_WGS__00	CUC_Cucumis_zeyherii_WGS
CUC_Cucumis_zeyherii_WGS__01	CUC_Cucumis_zeyherii_WGS
CUC_Cucumis_zeyherii_WGS__02	CUC_Cucumis_zeyherii_WGS
CUC_Cucumis_zeyherii_WGS__03	CUC_Cucumis_zeyherii_WGS
CUC_Cucumis_zeyherii_WGS__04	CUC_Cucumis_zeyherii_WGS
CUC_Cucumis_zeyherii_WGS__05	CUC_Cucumis_zeyherii_WGS
CUC_Cucurbita_argyrosperma_RNA	CUC_Cucurbita_argyrosperma_RNA
CUC_Cucurbita_argyrosperma_RNA__00	CUC_Cucurbita_argyrosperma_RNA
CUC_Cucurbita_argyrosperma_RNA__01	CUC_Cucurbita_argyrosperma_RNA
CUC_Cucurbita_argyrosperma_RNA__02	CUC_Cucurbita_argyrosperma_RNA
CUC_Cucurbita_cordata_RNA	CUC_Cucurbita_cordata_RNA
CUC_Cucurbita_cordata_RNA__00	CUC_Cucurbita_cordata_RNA
CUC_Cucurbita_cordata_RNA__01	CUC_Cucurbita_cordata_RNA
CUC_Cucurbita_cordata_RNA__02	CUC_Cucurbita_cordata_RNA
CUC_Cucurbita_digitata_GSK	CUC_Cucurbita_digitata_GSK
CUC_Cucurbita_digitata_GSK__00	CUC_Cucurbita_digitata_GSK
CUC_Cucurbita_digitata_GSK__01	CUC_Cucurbita_digitata_GSK
CUC_Cucurbita_digitata_GSK__02	CUC_Cucurbita_digitata_GSK
CUC_Cucurbita_ecuadorensis	CUC_Cucurbita_ecuadorensis
CUC_Cucurbita_ecuadorensis_1_RNA	CUC_Cucurbita_ecuadorensis_1_RNA
CUC_Cucurbita_ecuadorensis_1_RNA__00	CUC_Cucurbita_ecuadorensis_1_RNA
CUC_Cucurbita_ecuadorensis_1_RNA__01	CUC_Cucurbita_ecuadorensis_1_RNA
CUC_Cucurbita_ecuadorensis_1_RNA__02	CUC_Cucurbita_ecuadorensis_1_RNA
CUC_Cucurbita_ecuadorensis_1_RNA__03	CUC_Cucurbita_ecuadorensis_1_RNA
CUC_Cucurbita_ecuadorensis_1_RNA__04	CUC_Cucurbita_ecuadorensis_1_RNA
CUC_Cucurbita_ecuadorensis_1_RNA__05	CUC_Cucurbita_ecuadorensis_1_RNA
CUC_Cucurbita_ecuadorensis_2_RNA	CUC_Cucurbita_ecuadorensis_2_RNA
CUC_Cucurbita_ecuadorensis_2_RNA__00	CUC_Cucurbita_ecuadorensis_2_RNA
CUC_Cucurbita_ecuadorensis_2_RNA__01	CUC_Cucurbita_ecuadorensis_2_RNA
CUC_Cucurbita_ecuadorensis_2_RNA__02	CUC_Cucurbita_ecuadorensis_2_RNA
CUC_Cucurbita_ecuadorensis__00	CUC_Cucurbita_ecuadorensis
CUC_Cucurbita_ecuadorensis__01	CUC_Cucurbita_ecuadorensis
CUC_Cucurbita_ecuadorensis__02	CUC_Cucurbita_ecuadorensis
CUC_Cucurbita_ecuadorensis__03	CUC_Cucurbita_ecuadorensis
CUC_Cucurbita_ecuadorensis__04	CUC_Cucurbita_ecuadorensis
CUC_Cucurbita_ficifolia_RNA	CUC_Cucurbita_ficifolia_RNA
CUC_Cucurbita_ficifolia_RNA__00	CUC_Cucurbita_ficifolia_RNA
CUC_Cucurbita_ficifolia_RNA__01	CUC_Cucurbita_ficifolia_RNA
CUC_Cucurbita_ficifolia_RNA__02	CUC_Cucurbita_ficifolia_RNA
CUC_Cucurbita_foetidissima_1_RNA	CUC_Cucurbita_foetidissima_1_RNA
CUC_Cucurbita_foetidissima_1_RNA__00	CUC_Cucurbita_foetidissima_1_RNA
CUC_Cucurbita_foetidissima_1_RNA__01	CUC_Cucurbita_foetidissima_1_RNA
CUC_Cucurbita_foetidissima_1_RNA__02	CUC_Cucurbita_foetidissima_1_RNA
CUC_Cucurbita_foetidissima_1_RNA__03	CUC_Cucurbita_foetidissima_1_RNA
CUC_Cucurbita_foetidissima_1_RNA__04	CUC_Cucurbita_foetidissima_1_RNA
CUC_Cucurbita_foetidissima_1_RNA__05	CUC_Cucurbita_foetidissima_1_RNA
CUC_Cucurbita_foetidissima_2_RNA	CUC_Cucurbita_foetidissima_2_RNA
CUC_Cucurbita_foetidissima_2_RNA__00	CUC_Cucurbita_foetidissima_2_RNA
CUC_Cucurbita_foetidissima_2_RNA__01	CUC_Cucurbita_foetidissima_2_RNA
CUC_Cucurbita_foetidissima_2_RNA__02	CUC_Cucurbita_foetidissima_2_RNA
CUC_Cucurbita_foetidissima_2_RNA__03	CUC_Cucurbita_foetidissima_2_RNA
CUC_Cucurbita_foetidissima_2_RNA__04	CUC_Cucurbita_foetidissima_2_RNA
CUC_Cucurbita_lundelliana_RNA	CUC_Cucurbita_lundelliana_RNA
CUC_Cucurbita_lundelliana_RNA__00	CUC_Cucurbita_lundelliana_RNA
CUC_Cucurbita_lundelliana_RNA__01	CUC_Cucurbita_lundelliana_RNA
CUC_Cucurbita_lundelliana_RNA__02	CUC_Cucurbita_lundelliana_RNA
CUC_Cucurbita_maxima_RNA	CUC_Cucurbita_maxima_RNA
CUC_Cucurbita_maxima_RNA__00	CUC_Cucurbita_maxima_RNA
CUC_Cucurbita_maxima_RNA__01	CUC_Cucurbita_maxima_RNA
CUC_Cucurbita_maxima_RNA__02	CUC_Cucurbita_maxima_RNA
CUC_Cucurbita_moschata_RNA	CUC_Cucurbita_moschata_RNA
CUC_Cucurbita_moschata_RNA__00	CUC_Cucurbita_moschata_RNA
CUC_Cucurbita_moschata_RNA__01	CUC_Cucurbita_moschata_RNA
CUC_Cucurbita_moschata_RNA__02	CUC_Cucurbita_moschata_RNA
CUC_Cucurbita_moschata_RNA__03	CUC_Cucurbita_moschata_RNA
CUC_Cucurbita_moschata_RNA__04	CUC_Cucurbita_moschata_RNA
CUC_Cucurbita_moschata_RNA__05	CUC_Cucurbita_moschata_RNA
CUC_Cucurbita_okeechobeensis_RNA	CUC_Cucurbita_okeechobeensis_RNA
CUC_Cucurbita_okeechobeensis_RNA__00	CUC_Cucurbita_okeechobeensis_RNA
CUC_Cucurbita_okeechobeensis_RNA__01	CUC_Cucurbita_okeechobeensis_RNA
CUC_Cucurbita_okeechobeensis_RNA__02	CUC_Cucurbita_okeechobeensis_RNA
CUC_Cucurbita_okeechobeensis_RNA__03	CUC_Cucurbita_okeechobeensis_RNA
CUC_Cucurbita_palmata_RNA	CUC_Cucurbita_palmata_RNA
CUC_Cucurbita_palmata_RNA__00	CUC_Cucurbita_palmata_RNA
CUC_Cucurbita_palmata_RNA__01	CUC_Cucurbita_palmata_RNA
CUC_Cucurbita_palmata_RNA__02	CUC_Cucurbita_palmata_RNA
CUC_Cucurbita_palmata_RNA__03	CUC_Cucurbita_palmata_RNA
CUC_Cucurbita_palmata_RNA__04	CUC_Cucurbita_palmata_RNA
CUC_Cucurbita_palmata_RNA__05	CUC_Cucurbita_palmata_RNA
CUC_Cucurbita_pedatifolia_RNA	CUC_Cucurbita_pedatifolia_RNA
CUC_Cucurbita_pedatifolia_RNA__00	CUC_Cucurbita_pedatifolia_RNA
CUC_Cucurbita_pedatifolia_RNA__01	CUC_Cucurbita_pedatifolia_RNA
CUC_Cucurbita_pedatifolia_RNA__02	CUC_Cucurbita_pedatifolia_RNA
CUC_Cucurbita_pedatifolia_RNA__03	CUC_Cucurbita_pedatifolia_RNA
CUC_Cucurbita_pedatifolia_RNA__04	CUC_Cucurbita_pedatifolia_RNA
CUC_Cucurbita_pedatifolia_RNA__05	CUC_Cucurbita_pedatifolia_RNA
CUC_Cucurbita_pepo_subsp_pepo_RNA	CUC_Cucurbita_pepo_subsp_pepo_RNA
CUC_Cucurbita_pepo_subsp_pepo_RNA__00	CUC_Cucurbita_pepo_subsp_pepo_RNA
CUC_Cucurbita_pepo_subsp_pepo_RNA__01	CUC_Cucurbita_pepo_subsp_pepo_RNA
CUC_Cucurbita_pepo_subsp_pepo_RNA__02	CUC_Cucurbita_pepo_subsp_pepo_RNA
CUC_Cucurbita_pepo_subsp_pepo_RNA__03	CUC_Cucurbita_pepo_subsp_pepo_RNA
CUC_Cucurbita_pepo_subsp_pepo_RNA__04	CUC_Cucurbita_pepo_subsp_pepo_RNA
CUC_Cucurbita_pepo_subsp_pepo_RNA__05	CUC_Cucurbita_pepo_subsp_pepo_RNA
CUC_Cucurbita_pepo_subsp_texana_RNA	CUC_Cucurbita_pepo_subsp_texana_RNA
CUC_Cucurbita_pepo_subsp_texana_RNA__00	CUC_Cucurbita_pepo_subsp_texana_RNA
CUC_Cucurbita_pepo_subsp_texana_RNA__01	CUC_Cucurbita_pepo_subsp_texana_RNA
CUC_Cucurbita_pepo_subsp_texana_RNA__02	CUC_Cucurbita_pepo_subsp_texana_RNA
CUC_Cucurbita_pepo_subsp_texana_RNA__03	CUC_Cucurbita_pepo_subsp_texana_RNA
CUC_Cucurbita_pepo_subsp_texana_RNA__04	CUC_Cucurbita_pepo_subsp_texana_RNA
CUC_Cucurbita_pepo_subsp_texana_RNA__05	CUC_Cucurbita_pepo_subsp_texana_RNA
CUC_Cucurbita_pepo_var_ovifera_GSK	CUC_Cucurbita_pepo_var_ovifera_GSK
CUC_Cucurbita_pepo_var_ovifera_GSK__00	CUC_Cucurbita_pepo_var_ovifera_GSK
CUC_Cucurbita_pepo_var_ovifera_GSK__01	CUC_Cucurbita_pepo_var_ovifera_GSK
CUC_Cucurbita_pepo_var_ovifera_GSK__02	CUC_Cucurbita_pepo_var_ovifera_GSK
CUC_Cucurbita_pepo_var_ozarkana_GSK	CUC_Cucurbita_pepo_var_ozarkana_GSK
CUC_Cucurbita_pepo_var_ozarkana_GSK__00	CUC_Cucurbita_pepo_var_ozarkana_GSK
CUC_Cucurbita_pepo_var_ozarkana_GSK__01	CUC_Cucurbita_pepo_var_ozarkana_GSK
CUC_Cucurbitella_duriaei	CUC_Cucurbitella_duriaei
CUC_Cucurbitella_duriaei__00	CUC_Cucurbitella_duriaei
CUC_Cucurbitella_duriaei__01	CUC_Cucurbitella_duriaei
CUC_Cucurbitella_duriaei__02	CUC_Cucurbitella_duriaei
CUC_Cucurbitopsis_aspera_RNA	CUC_Cucurbitopsis_aspera_RNA
CUC_Cucurbitopsis_aspera_RNA__00	CUC_Cucurbitopsis_aspera_RNA
CUC_Cucurbitopsis_aspera_RNA__01	CUC_Cucurbitopsis_aspera_RNA
CUC_Cucurbitopsis_aspera_RNA__02	CUC_Cucurbitopsis_aspera_RNA
CUC_Cucurbitopsis_aspera_RNA__03	CUC_Cucurbitopsis_aspera_RNA
CUC_Cucurbitopsis_aspera_RNA__04	CUC_Cucurbitopsis_aspera_RNA
CUC_Cucurbitopsis_aspera_RNA__05	CUC_Cucurbitopsis_aspera_RNA
CUC_Cyclanthera_mathewsii_RNA	CUC_Cyclanthera_mathewsii_RNA
CUC_Cyclanthera_mathewsii_RNA__00	CUC_Cyclanthera_mathewsii_RNA
CUC_Cyclanthera_mathewsii_RNA__01	CUC_Cyclanthera_mathewsii_RNA
CUC_Cyclanthera_pedata_RNA	CUC_Cyclanthera_pedata_RNA
CUC_Cyclanthera_pedata_RNA__00	CUC_Cyclanthera_pedata_RNA
CUC_Cyclanthera_pedata_RNA__01	CUC_Cyclanthera_pedata_RNA
CUC_Cyclanthera_pedata_RNA__02	CUC_Cyclanthera_pedata_RNA
CUC_Cyclanthera_pedata_RNA__03	CUC_Cyclanthera_pedata_RNA
CUC_Cyclanthera_pedata_RNA__04	CUC_Cyclanthera_pedata_RNA
CUC_Cyclanthera_pedata_RNA__05	CUC_Cyclanthera_pedata_RNA
CUC_Cyclanthera_pedata_SB21_GSK	CUC_Cyclanthera_pedata_SB21_GSK
CUC_Cyclanthera_pedata_SB21_GSK__00	CUC_Cyclanthera_pedata_SB21_GSK
CUC_Cyclanthera_pedata_SB21_GSK__01	CUC_Cyclanthera_pedata_SB21_GSK
CUC_Cyclanthera_pedata_SB21_GSK__02	CUC_Cyclanthera_pedata_SB21_GSK
CUC_Cyclantheropsis_parviflora	CUC_Cyclantheropsis_parviflora
CUC_Cyclantheropsis_parviflora_1_RNA	CUC_Cyclantheropsis_parviflora_1_RNA
CUC_Cyclantheropsis_parviflora_1_RNA__00	CUC_Cyclantheropsis_parviflora_1_RNA
CUC_Cyclantheropsis_parviflora_1_RNA__01	CUC_Cyclantheropsis_parviflora_1_RNA
CUC_Cyclantheropsis_parviflora_1_RNA__02	CUC_Cyclantheropsis_parviflora_1_RNA
CUC_Cyclantheropsis_parviflora_1_RNA__03	CUC_Cyclantheropsis_parviflora_1_RNA
CUC_Cyclantheropsis_parviflora_1_RNA__04	CUC_Cyclantheropsis_parviflora_1_RNA
CUC_Cyclantheropsis_parviflora_1_RNA__05	CUC_Cyclantheropsis_parviflora_1_RNA
CUC_Cyclantheropsis_parviflora_2_RNA	CUC_Cyclantheropsis_parviflora_2_RNA
CUC_Cyclantheropsis_parviflora_2_RNA__00	CUC_Cyclantheropsis_parviflora_2_RNA
CUC_Cyclantheropsis_parviflora_2_RNA__01	CUC_Cyclantheropsis_parviflora_2_RNA
CUC_Cyclantheropsis_parviflora_2_RNA__02	CUC_Cyclantheropsis_parviflora_2_RNA
CUC_Cyclantheropsis_parviflora_2_RNA__03	CUC_Cyclantheropsis_parviflora_2_RNA
CUC_Cyclantheropsis_parviflora_2_RNA__04	CUC_Cyclantheropsis_parviflora_2_RNA
CUC_Cyclantheropsis_parviflora_2_RNA__05	CUC_Cyclantheropsis_parviflora_2_RNA
CUC_Cyclantheropsis_parviflora_SB11_GSK	CUC_Cyclantheropsis_parviflora_SB11_GSK
CUC_Cyclantheropsis_parviflora_SB11_GSK__00	CUC_Cyclantheropsis_parviflora_SB11_GSK
CUC_Cyclantheropsis_parviflora_SB11_GSK__01	CUC_Cyclantheropsis_parviflora_SB11_GSK
CUC_Cyclantheropsis_parviflora_SB11_GSK__02	CUC_Cyclantheropsis_parviflora_SB11_GSK
CUC_Cyclantheropsis_parviflora_SB11_GSK__03	CUC_Cyclantheropsis_parviflora_SB11_GSK
CUC_Cyclantheropsis_parviflora_SB11_GSK__04	CUC_Cyclantheropsis_parviflora_SB11_GSK
CUC_Cyclantheropsis_parviflora_SB11_GSK__05	CUC_Cyclantheropsis_parviflora_SB11_GSK
CUC_Cyclantheropsis_parviflora__00	CUC_Cyclantheropsis_parviflora
CUC_Cyclantheropsis_parviflora__01	CUC_Cyclantheropsis_parviflora
CUC_Cyclantheropsis_parviflora__02	CUC_Cyclantheropsis_parviflora
CUC_Cyclantheropsis_parviflora__03	CUC_Cyclantheropsis_parviflora
CUC_Cyclantheropsis_parviflora__04	CUC_Cyclantheropsis_parviflora
CUC_Cyclantheropsis_parviflora__05	CUC_Cyclantheropsis_parviflora
CUC_Dactyliandra_welwitschii	CUC_Dactyliandra_welwitschii
CUC_Dactyliandra_welwitschii__00	CUC_Dactyliandra_welwitschii
CUC_Dactyliandra_welwitschii__01	CUC_Dactyliandra_welwitschii
CUC_Dactyliandra_welwitschii__02	CUC_Dactyliandra_welwitschii
CUC_Dactyliandra_welwitschii__03	CUC_Dactyliandra_welwitschii
CUC_Dendrosicyos_socotranus	CUC_Dendrosicyos_socotranus
CUC_Dendrosicyos_socotranus_HS5731_WGS	CUC_Dendrosicyos_socotranus_HS5731_WGS
CUC_Dendrosicyos_socotranus_HS5731_WGS__00	CUC_Dendrosicyos_socotranus_HS5731_WGS
CUC_Dendrosicyos_socotranus_HS5731_WGS__01	CUC_Dendrosicyos_socotranus_HS5731_WGS
CUC_Dendrosicyos_socotranus_HS5731_WGS__02	CUC_Dendrosicyos_socotranus_HS5731_WGS
CUC_Dendrosicyos_socotranus_HS5731_WGS__03	CUC_Dendrosicyos_socotranus_HS5731_WGS
CUC_Dendrosicyos_socotranus_SB25_GSK	CUC_Dendrosicyos_socotranus_SB25_GSK
CUC_Dendrosicyos_socotranus_SB25_GSK__00	CUC_Dendrosicyos_socotranus_SB25_GSK
CUC_Dendrosicyos_socotranus_SB25_GSK__01	CUC_Dendrosicyos_socotranus_SB25_GSK
CUC_Dendrosicyos_socotranus__00	CUC_Dendrosicyos_socotranus
CUC_Dendrosicyos_socotranus__01	CUC_Dendrosicyos_socotranus
CUC_Dendrosicyos_socotranus__02	CUC_Dendrosicyos_socotranus
CUC_Dendrosicyos_socotranus__03	CUC_Dendrosicyos_socotranus
CUC_Diplocyclos_palmatus	CUC_Diplocyclos_palmatus
CUC_Diplocyclos_palmatus_RNA	CUC_Diplocyclos_palmatus_RNA
CUC_Diplocyclos_palmatus_RNA__00	CUC_Diplocyclos_palmatus_RNA
CUC_Diplocyclos_palmatus_RNA__01	CUC_Diplocyclos_palmatus_RNA
CUC_Diplocyclos_palmatus_RNA__02	CUC_Diplocyclos_palmatus_RNA
CUC_Diplocyclos_palmatus_RNA__03	CUC_Diplocyclos_palmatus_RNA
CUC_Diplocyclos_palmatus__00	CUC_Diplocyclos_palmatus
CUC_Diplocyclos_palmatus__01	CUC_Diplocyclos_palmatus
CUC_Diplocyclos_palmatus__02	CUC_Diplocyclos_palmatus
CUC_Doyerea_emetocathartica	CUC_Doyerea_emetocathartica
CUC_Doyerea_emetocathartica__00	CUC_Doyerea_emetocathartica
CUC_Doyerea_emetocathartica__01	CUC_Doyerea_emetocathartica
CUC_Doyerea_emetocathartica__02	CUC_Doyerea_emetocathartica
CUC_Doyerea_emetocathartica__03	CUC_Doyerea_emetocathartica
CUC_Doyerea_emetocathartica__04	CUC_Doyerea_emetocathartica
CUC_Doyerea_emetocathartica__05	CUC_Doyerea_emetocathartica
CUC_Doyerea_trifoliata	CUC_Doyerea_trifoliata
CUC_Doyerea_trifoliata__00	CUC_Doyerea_trifoliata
CUC_Doyerea_trifoliata__01	CUC_Doyerea_trifoliata
CUC_Doyerea_trifoliata__02	CUC_Doyerea_trifoliata
CUC_Doyerea_trifoliata__03	CUC_Doyerea_trifoliata
CUC_Doyerea_trifoliata__04	CUC_Doyerea_trifoliata
CUC_Doyerea_trifoliata__05	CUC_Doyerea_trifoliata
CUC_Ecballium_elaterium	CUC_Ecballium_elaterium
CUC_Ecballium_elaterium_RNA	CUC_Ecballium_elaterium_RNA
CUC_Ecballium_elaterium_RNA__00	CUC_Ecballium_elaterium_RNA
CUC_Ecballium_elaterium_RNA__01	CUC_Ecballium_elaterium_RNA
CUC_Ecballium_elaterium_RNA__02	CUC_Ecballium_elaterium_RNA
CUC_Ecballium_elaterium_RNA__03	CUC_Ecballium_elaterium_RNA
CUC_Ecballium_elaterium_RNA__04	CUC_Ecballium_elaterium_RNA
CUC_Ecballium_elaterium_RNA__05	CUC_Ecballium_elaterium_RNA
CUC_Ecballium_elaterium__00	CUC_Ecballium_elaterium
CUC_Ecballium_elaterium__01	CUC_Ecballium_elaterium
CUC_Ecballium_elaterium__02	CUC_Ecballium_elaterium
CUC_Ecballium_elaterium__03	CUC_Ecballium_elaterium
CUC_Ecballium_elaterium__04	CUC_Ecballium_elaterium
CUC_Ecballium_elaterium__05	CUC_Ecballium_elaterium
CUC_Echinocystis_lobata	CUC_Echinocystis_lobata
CUC_Echinocystis_lobata_RNA	CUC_Echinocystis_lobata_RNA
CUC_Echinocystis_lobata_RNA__00	CUC_Echinocystis_lobata_RNA
CUC_Echinocystis_lobata_RNA__01	CUC_Echinocystis_lobata_RNA
CUC_Echinocystis_lobata_RNA__02	CUC_Echinocystis_lobata_RNA
CUC_Echinocystis_lobata_RNA__03	CUC_Echinocystis_lobata_RNA
CUC_Echinocystis_lobata_RNA__04	CUC_Echinocystis_lobata_RNA
CUC_Echinocystis_lobata_RNA__05	CUC_Echinocystis_lobata_RNA
CUC_Echinocystis_lobata__00	CUC_Echinocystis_lobata
CUC_Echinocystis_lobata__01	CUC_Echinocystis_lobata
CUC_Echinocystis_lobata__02	CUC_Echinocystis_lobata
CUC_Echinocystis_lobata__03	CUC_Echinocystis_lobata
CUC_Echinocystis_lobata__04	CUC_Echinocystis_lobata
CUC_Echinocystis_lobata__05	CUC_Echinocystis_lobata
CUC_Echinopepon_bigelovii	CUC_Echinopepon_bigelovii
CUC_Echinopepon_bigelovii_RNA	CUC_Echinopepon_bigelovii_RNA
CUC_Echinopepon_bigelovii_RNA__00	CUC_Echinopepon_bigelovii_RNA
CUC_Echinopepon_bigelovii_RNA__01	CUC_Echinopepon_bigelovii_RNA
CUC_Echinopepon_bigelovii_RNA__02	CUC_Echinopepon_bigelovii_RNA
CUC_Echinopepon_bigelovii_RNA__03	CUC_Echinopepon_bigelovii_RNA
CUC_Echinopepon_bigelovii_RNA__04	CUC_Echinopepon_bigelovii_RNA
CUC_Echinopepon_bigelovii_RNA__05	CUC_Echinopepon_bigelovii_RNA
CUC_Echinopepon_bigelovii__00	CUC_Echinopepon_bigelovii
CUC_Echinopepon_bigelovii__01	CUC_Echinopepon_bigelovii
CUC_Echinopepon_bigelovii__02	CUC_Echinopepon_bigelovii
CUC_Echinopepon_bigelovii__03	CUC_Echinopepon_bigelovii
CUC_Echinopepon_bigelovii__04	CUC_Echinopepon_bigelovii
CUC_Echinopepon_bigelovii__05	CUC_Echinopepon_bigelovii
CUC_Echinopepon_milliflorus	CUC_Echinopepon_milliflorus
CUC_Echinopepon_milliflorus__00	CUC_Echinopepon_milliflorus
CUC_Echinopepon_milliflorus__01	CUC_Echinopepon_milliflorus
CUC_Echinopepon_milliflorus__02	CUC_Echinopepon_milliflorus
CUC_Echinopepon_milliflorus__03	CUC_Echinopepon_milliflorus
CUC_Echinopepon_milliflorus__04	CUC_Echinopepon_milliflorus
CUC_Echinopepon_milliflorus__05	CUC_Echinopepon_milliflorus
CUC_Eureiandra_eburnea	CUC_Eureiandra_eburnea
CUC_Eureiandra_eburnea__00	CUC_Eureiandra_eburnea
CUC_Eureiandra_eburnea__01	CUC_Eureiandra_eburnea
CUC_Eureiandra_eburnea__02	CUC_Eureiandra_eburnea
CUC_Eureiandra_eburnea__03	CUC_Eureiandra_eburnea
CUC_Eureiandra_eburnea__04	CUC_Eureiandra_eburnea
CUC_Eureiandra_eburnea__05	CUC_Eureiandra_eburnea
CUC_Fevillea_cordifolia_WGS	CUC_Fevillea_cordifolia_WGS
CUC_Fevillea_cordifolia_WGS__00	CUC_Fevillea_cordifolia_WGS
CUC_Fevillea_cordifolia_WGS__01	CUC_Fevillea_cordifolia_WGS
CUC_Fevillea_cordifolia_WGS__02	CUC_Fevillea_cordifolia_WGS
CUC_Fevillea_cordifolia_WGS__03	CUC_Fevillea_cordifolia_WGS
CUC_Fevillea_cordifolia_WGS__04	CUC_Fevillea_cordifolia_WGS
CUC_Fevillea_cordifolia_WGS__05	CUC_Fevillea_cordifolia_WGS
CUC_Fevillea_pedatifolia_GSK	CUC_Fevillea_pedatifolia_GSK
CUC_Fevillea_pedatifolia_GSK__00	CUC_Fevillea_pedatifolia_GSK
CUC_Fevillea_pedatifolia_GSK__01	CUC_Fevillea_pedatifolia_GSK
CUC_Fevillea_pedatifolia_GSK__02	CUC_Fevillea_pedatifolia_GSK
CUC_Fevillea_pedatifolia_GSK__03	CUC_Fevillea_pedatifolia_GSK
CUC_Fevillea_pedatifolia_GSK__04	CUC_Fevillea_pedatifolia_GSK
CUC_Fevillea_pedatifolia_GSK__05	CUC_Fevillea_pedatifolia_GSK
CUC_Fevillea_pergamentacea	CUC_Fevillea_pergamentacea
CUC_Fevillea_pergamentacea__00	CUC_Fevillea_pergamentacea
CUC_Fevillea_pergamentacea__01	CUC_Fevillea_pergamentacea
CUC_Fevillea_pergamentacea__02	CUC_Fevillea_pergamentacea
CUC_Fevillea_pergamentacea__03	CUC_Fevillea_pergamentacea
CUC_Fevillea_pergamentacea__04	CUC_Fevillea_pergamentacea
CUC_Fevillea_pergamentacea__05	CUC_Fevillea_pergamentacea
CUC_Frantzia_pittieri_RNA	CUC_Frantzia_pittieri_RNA
CUC_Frantzia_pittieri_RNA__00	CUC_Frantzia_pittieri_RNA
CUC_Frantzia_pittieri_RNA__01	CUC_Frantzia_pittieri_RNA
CUC_Frantzia_pittieri_RNA__02	CUC_Frantzia_pittieri_RNA
CUC_Frantzia_pittieri_RNA__03	CUC_Frantzia_pittieri_RNA
CUC_Frantzia_pittieri_RNA__04	CUC_Frantzia_pittieri_RNA
CUC_Frantzia_pittieri_RNA__05	CUC_Frantzia_pittieri_RNA
CUC_Frantzia_tacaco	CUC_Frantzia_tacaco
CUC_Frantzia_tacaco__00	CUC_Frantzia_tacaco
CUC_Frantzia_tacaco__01	CUC_Frantzia_tacaco
CUC_Frantzia_tacaco__02	CUC_Frantzia_tacaco
CUC_Gerrardanthus_lobatus_RNA	CUC_Gerrardanthus_lobatus_RNA
CUC_Gerrardanthus_lobatus_RNA__00	CUC_Gerrardanthus_lobatus_RNA
CUC_Gerrardanthus_lobatus_RNA__01	CUC_Gerrardanthus_lobatus_RNA
CUC_Gerrardanthus_lobatus_RNA__02	CUC_Gerrardanthus_lobatus_RNA
CUC_Gerrardanthus_lobatus_RNA__03	CUC_Gerrardanthus_lobatus_RNA
CUC_Gerrardanthus_lobatus_RNA__04	CUC_Gerrardanthus_lobatus_RNA
CUC_Gerrardanthus_macrorhizus	CUC_Gerrardanthus_macrorhizus
CUC_Gerrardanthus_macrorhizus_RNA	CUC_Gerrardanthus_macrorhizus_RNA
CUC_Gerrardanthus_macrorhizus_RNA__00	CUC_Gerrardanthus_macrorhizus_RNA
CUC_Gerrardanthus_macrorhizus_RNA__01	CUC_Gerrardanthus_macrorhizus_RNA
CUC_Gerrardanthus_macrorhizus_RNA__02	CUC_Gerrardanthus_macrorhizus_RNA
CUC_Gerrardanthus_macrorhizus_RNA__03	CUC_Gerrardanthus_macrorhizus_RNA
CUC_Gerrardanthus_macrorhizus_SB22_GSK	CUC_Gerrardanthus_macrorhizus_SB22_GSK
CUC_Gerrardanthus_macrorhizus_SB22_GSK__00	CUC_Gerrardanthus_macrorhizus_SB22_GSK
CUC_Gerrardanthus_macrorhizus_SB22_GSK__01	CUC_Gerrardanthus_macrorhizus_SB22_GSK
CUC_Gerrardanthus_macrorhizus_SB22_GSK__02	CUC_Gerrardanthus_macrorhizus_SB22_GSK
CUC_Gerrardanthus_macrorhizus_SB22_GSK__03	CUC_Gerrardanthus_macrorhizus_SB22_GSK
CUC_Gerrardanthus_macrorhizus_SB22_GSK__04	CUC_Gerrardanthus_macrorhizus_SB22_GSK
CUC_Gerrardanthus_macrorhizus_SB22_GSK__05	CUC_Gerrardanthus_macrorhizus_SB22_GSK
CUC_Gerrardanthus_macrorhizus__00	CUC_Gerrardanthus_macrorhizus
CUC_Gerrardanthus_macrorhizus__01	CUC_Gerrardanthus_macrorhizus
CUC_Gerrardanthus_macrorhizus__02	CUC_Gerrardanthus_macrorhizus
CUC_Gerrardanthus_macrorhizus__03	CUC_Gerrardanthus_macrorhizus
CUC_Gerrardanthus_macrorhizus__04	CUC_Gerrardanthus_macrorhizus
CUC_Gomphogyne_cissiformis	CUC_Gomphogyne_cissiformis
CUC_Gomphogyne_cissiformis_RNA	CUC_Gomphogyne_cissiformis_RNA
CUC_Gomphogyne_cissiformis_RNA__00	CUC_Gomphogyne_cissiformis_RNA
CUC_Gomphogyne_cissiformis_RNA__01	CUC_Gomphogyne_cissiformis_RNA
CUC_Gomphogyne_cissiformis_RNA__02	CUC_Gomphogyne_cissiformis_RNA
CUC_Gomphogyne_cissiformis_RNA__03	CUC_Gomphogyne_cissiformis_RNA
CUC_Gomphogyne_cissiformis_RNA__04	CUC_Gomphogyne_cissiformis_RNA
CUC_Gomphogyne_cissiformis_RNA__05	CUC_Gomphogyne_cissiformis_RNA
CUC_Gomphogyne_cissiformis__00	CUC_Gomphogyne_cissiformis
CUC_Gomphogyne_cissiformis__01	CUC_Gomphogyne_cissiformis
CUC_Gomphogyne_cissiformis__02	CUC_Gomphogyne_cissiformis
CUC_Gurania_lobata_GJ079_RNA	CUC_Gurania_lobata_GJ079_RNA
CUC_Gurania_lobata_GJ079_RNA__00	CUC_Gurania_lobata_GJ079_RNA
CUC_Gurania_lobata_GJ079_RNA__01	CUC_Gurania_lobata_GJ079_RNA
CUC_Gurania_lobata_GJ079_RNA__02	CUC_Gurania_lobata_GJ079_RNA
CUC_Gurania_lobata_GJ079_RNA__03	CUC_Gurania_lobata_GJ079_RNA
CUC_Gurania_lobata_GJ079_RNA__04	CUC_Gurania_lobata_GJ079_RNA
CUC_Gurania_lobata_GJ079_RNA__05	CUC_Gurania_lobata_GJ079_RNA
CUC_Gurania_subumbellata	CUC_Gurania_subumbellata
CUC_Gurania_subumbellata__00	CUC_Gurania_subumbellata
CUC_Gurania_subumbellata__01	CUC_Gurania_subumbellata
CUC_Gurania_subumbellata__02	CUC_Gurania_subumbellata
CUC_Gynostemma_aggregatum_RNA	CUC_Gynostemma_aggregatum_RNA
CUC_Gynostemma_aggregatum_RNA__00	CUC_Gynostemma_aggregatum_RNA
CUC_Gynostemma_aggregatum_RNA__01	CUC_Gynostemma_aggregatum_RNA
CUC_Gynostemma_aggregatum_RNA__02	CUC_Gynostemma_aggregatum_RNA
CUC_Gynostemma_aggregatum_RNA__03	CUC_Gynostemma_aggregatum_RNA
CUC_Gynostemma_aggregatum_RNA__04	CUC_Gynostemma_aggregatum_RNA
CUC_Gynostemma_aggregatum_RNA__05	CUC_Gynostemma_aggregatum_RNA
CUC_Gynostemma_burmanicum	CUC_Gynostemma_burmanicum
CUC_Gynostemma_burmanicum_SB16_GSK	CUC_Gynostemma_burmanicum_SB16_GSK
CUC_Gynostemma_burmanicum_SB16_GSK__00	CUC_Gynostemma_burmanicum_SB16_GSK
CUC_Gynostemma_burmanicum_SB16_GSK__01	CUC_Gynostemma_burmanicum_SB16_GSK
CUC_Gynostemma_burmanicum_SB16_GSK__02	CUC_Gynostemma_burmanicum_SB16_GSK
CUC_Gynostemma_burmanicum_SB16_GSK__03	CUC_Gynostemma_burmanicum_SB16_GSK
CUC_Gynostemma_burmanicum_SB16_GSK__04	CUC_Gynostemma_burmanicum_SB16_GSK
CUC_Gynostemma_burmanicum_SB16_GSK__05	CUC_Gynostemma_burmanicum_SB16_GSK
CUC_Gynostemma_burmanicum__00	CUC_Gynostemma_burmanicum
CUC_Gynostemma_burmanicum__01	CUC_Gynostemma_burmanicum
CUC_Gynostemma_burmanicum__02	CUC_Gynostemma_burmanicum
CUC_Gynostemma_burmanicum__03	CUC_Gynostemma_burmanicum
CUC_Gynostemma_burmanicum__04	CUC_Gynostemma_burmanicum
CUC_Gynostemma_burmanicum__05	CUC_Gynostemma_burmanicum
CUC_Gynostemma_cardiospermum_RNA	CUC_Gynostemma_cardiospermum_RNA
CUC_Gynostemma_cardiospermum_RNA__00	CUC_Gynostemma_cardiospermum_RNA
CUC_Gynostemma_cardiospermum_RNA__01	CUC_Gynostemma_cardiospermum_RNA
CUC_Gynostemma_cardiospermum_RNA__02	CUC_Gynostemma_cardiospermum_RNA
CUC_Gynostemma_cardiospermum_RNA__03	CUC_Gynostemma_cardiospermum_RNA
CUC_Gynostemma_cardiospermum_RNA__04	CUC_Gynostemma_cardiospermum_RNA
CUC_Gynostemma_compressum_RNA	CUC_Gynostemma_compressum_RNA
CUC_Gynostemma_compressum_RNA__00	CUC_Gynostemma_compressum_RNA
CUC_Gynostemma_compressum_RNA__01	CUC_Gynostemma_compressum_RNA
CUC_Gynostemma_compressum_RNA__02	CUC_Gynostemma_compressum_RNA
CUC_Gynostemma_compressum_RNA__03	CUC_Gynostemma_compressum_RNA
CUC_Gynostemma_compressum_RNA__04	CUC_Gynostemma_compressum_RNA
CUC_Gynostemma_compressum_RNA__05	CUC_Gynostemma_compressum_RNA
CUC_Gynostemma_laxum_RNA	CUC_Gynostemma_laxum_RNA
CUC_Gynostemma_laxum_RNA__00	CUC_Gynostemma_laxum_RNA
CUC_Gynostemma_laxum_RNA__01	CUC_Gynostemma_laxum_RNA
CUC_Gynostemma_laxum_RNA__02	CUC_Gynostemma_laxum_RNA
CUC_Gynostemma_laxum_RNA__03	CUC_Gynostemma_laxum_RNA
CUC_Gynostemma_laxum_RNA__04	CUC_Gynostemma_laxum_RNA
CUC_Gynostemma_laxum_RNA__05	CUC_Gynostemma_laxum_RNA
CUC_Gynostemma_longipes_leaf_RNA	CUC_Gynostemma_longipes_leaf_RNA
CUC_Gynostemma_longipes_leaf_RNA__00	CUC_Gynostemma_longipes_leaf_RNA
CUC_Gynostemma_longipes_leaf_RNA__01	CUC_Gynostemma_longipes_leaf_RNA
CUC_Gynostemma_longipes_leaf_RNA__02	CUC_Gynostemma_longipes_leaf_RNA
CUC_Gynostemma_longipes_leaf_RNA__03	CUC_Gynostemma_longipes_leaf_RNA
CUC_Gynostemma_longipes_leaf_RNA__04	CUC_Gynostemma_longipes_leaf_RNA
CUC_Gynostemma_longipes_leaf_RNA__05	CUC_Gynostemma_longipes_leaf_RNA
CUC_Gynostemma_longipes_rattan_RNA	CUC_Gynostemma_longipes_rattan_RNA
CUC_Gynostemma_longipes_rattan_RNA__00	CUC_Gynostemma_longipes_rattan_RNA
CUC_Gynostemma_longipes_rattan_RNA__01	CUC_Gynostemma_longipes_rattan_RNA
CUC_Gynostemma_longipes_rattan_RNA__02	CUC_Gynostemma_longipes_rattan_RNA
CUC_Gynostemma_longipes_rattan_RNA__03	CUC_Gynostemma_longipes_rattan_RNA
CUC_Gynostemma_longipes_rattan_RNA__04	CUC_Gynostemma_longipes_rattan_RNA
CUC_Gynostemma_longipes_rattan_RNA__05	CUC_Gynostemma_longipes_rattan_RNA
CUC_Gynostemma_longipes_stolon_RNA	CUC_Gynostemma_longipes_stolon_RNA
CUC_Gynostemma_longipes_stolon_RNA__00	CUC_Gynostemma_longipes_stolon_RNA
CUC_Gynostemma_longipes_stolon_RNA__01	CUC_Gynostemma_longipes_stolon_RNA
CUC_Gynostemma_longipes_stolon_RNA__02	CUC_Gynostemma_longipes_stolon_RNA
CUC_Gynostemma_longipes_stolon_RNA__03	CUC_Gynostemma_longipes_stolon_RNA
CUC_Gynostemma_longipes_stolon_RNA__04	CUC_Gynostemma_longipes_stolon_RNA
CUC_Gynostemma_longipes_stolon_RNA__05	CUC_Gynostemma_longipes_stolon_RNA
CUC_Gynostemma_microspermum_GJ058_RNA	CUC_Gynostemma_microspermum_GJ058_RNA
CUC_Gynostemma_microspermum_GJ058_RNA__00	CUC_Gynostemma_microspermum_GJ058_RNA
CUC_Gynostemma_microspermum_GJ058_RNA__01	CUC_Gynostemma_microspermum_GJ058_RNA
CUC_Gynostemma_microspermum_GJ058_RNA__02	CUC_Gynostemma_microspermum_GJ058_RNA
CUC_Gynostemma_microspermum_GSK	CUC_Gynostemma_microspermum_GSK
CUC_Gynostemma_microspermum_GSK__00	CUC_Gynostemma_microspermum_GSK
CUC_Gynostemma_microspermum_GSK__01	CUC_Gynostemma_microspermum_GSK
CUC_Gynostemma_microspermum_GSK__02	CUC_Gynostemma_microspermum_GSK
CUC_Gynostemma_microspermum_GSK__03	CUC_Gynostemma_microspermum_GSK
CUC_Gynostemma_microspermum_GSK__04	CUC_Gynostemma_microspermum_GSK
CUC_Gynostemma_microspermum_GSK__05	CUC_Gynostemma_microspermum_GSK
CUC_Gynostemma_pentaphyllum_RNA	CUC_Gynostemma_pentaphyllum_RNA
CUC_Gynostemma_pentaphyllum_RNA__00	CUC_Gynostemma_pentaphyllum_RNA
CUC_Gynostemma_pentaphyllum_RNA__01	CUC_Gynostemma_pentaphyllum_RNA
CUC_Gynostemma_pentaphyllum_RNA__02	CUC_Gynostemma_pentaphyllum_RNA
CUC_Gynostemma_pentaphyllum_RNA__03	CUC_Gynostemma_pentaphyllum_RNA
CUC_Gynostemma_pentaphyllum_RNA__04	CUC_Gynostemma_pentaphyllum_RNA
CUC_Gynostemma_pentaphyllum_RNA__05	CUC_Gynostemma_pentaphyllum_RNA
CUC_Gynostemma_pubescens_RNA	CUC_Gynostemma_pubescens_RNA
CUC_Gynostemma_pubescens_RNA__00	CUC_Gynostemma_pubescens_RNA
CUC_Gynostemma_pubescens_RNA__01	CUC_Gynostemma_pubescens_RNA
CUC_Gynostemma_pubescens_RNA__02	CUC_Gynostemma_pubescens_RNA
CUC_Gynostemma_pubescens_RNA__03	CUC_Gynostemma_pubescens_RNA
CUC_Gynostemma_pubescens_RNA__04	CUC_Gynostemma_pubescens_RNA
CUC_Gynostemma_pubescens_RNA__05	CUC_Gynostemma_pubescens_RNA
CUC_Gynostemma_yixingense_WGS	CUC_Gynostemma_yixingense_WGS
CUC_Gynostemma_yixingense_WGS__00	CUC_Gynostemma_yixingense_WGS
CUC_Gynostemma_yixingense_WGS__01	CUC_Gynostemma_yixingense_WGS
CUC_Gynostemma_yixingense_WGS__02	CUC_Gynostemma_yixingense_WGS
CUC_Gynostemma_yixingense_WGS__03	CUC_Gynostemma_yixingense_WGS
CUC_Gynostemma_yixingense_WGS__04	CUC_Gynostemma_yixingense_WGS
CUC_Gynostemma_yixingense_WGS__05	CUC_Gynostemma_yixingense_WGS
CUC_Halosicyos_ragonesei	CUC_Halosicyos_ragonesei
CUC_Halosicyos_ragonesei__00	CUC_Halosicyos_ragonesei
CUC_Halosicyos_ragonesei__01	CUC_Halosicyos_ragonesei
CUC_Halosicyos_ragonesei__02	CUC_Halosicyos_ragonesei
CUC_Halosicyos_ragonesei__03	CUC_Halosicyos_ragonesei
CUC_Halosicyos_ragonesei__04	CUC_Halosicyos_ragonesei
CUC_Halosicyos_ragonesei__05	CUC_Halosicyos_ragonesei
CUC_Hanburia_mexicana	CUC_Hanburia_mexicana
CUC_Hanburia_mexicana__00	CUC_Hanburia_mexicana
CUC_Hanburia_mexicana__01	CUC_Hanburia_mexicana
CUC_Hemsleya_amabilis	CUC_Hemsleya_amabilis
CUC_Hemsleya_amabilis__00	CUC_Hemsleya_amabilis
CUC_Hemsleya_amabilis__01	CUC_Hemsleya_amabilis
CUC_Hemsleya_amabilis__02	CUC_Hemsleya_amabilis
CUC_Hemsleya_amabilis__03	CUC_Hemsleya_amabilis
CUC_Hemsleya_amabilis__04	CUC_Hemsleya_amabilis
CUC_Hemsleya_amabilis__05	CUC_Hemsleya_amabilis
CUC_Hemsleya_carnosiflora_RNA	CUC_Hemsleya_carnosiflora_RNA
CUC_Hemsleya_carnosiflora_RNA__00	CUC_Hemsleya_carnosiflora_RNA
CUC_Hemsleya_carnosiflora_RNA__01	CUC_Hemsleya_carnosiflora_RNA
CUC_Hemsleya_carnosiflora_RNA__02	CUC_Hemsleya_carnosiflora_RNA
CUC_Hemsleya_carnosiflora_RNA__03	CUC_Hemsleya_carnosiflora_RNA
CUC_Hemsleya_carnosiflora_RNA__04	CUC_Hemsleya_carnosiflora_RNA
CUC_Hemsleya_carnosiflora_RNA__05	CUC_Hemsleya_carnosiflora_RNA
CUC_Hemsleya_chinensis_RNA	CUC_Hemsleya_chinensis_RNA
CUC_Hemsleya_chinensis_RNA__00	CUC_Hemsleya_chinensis_RNA
CUC_Hemsleya_chinensis_RNA__01	CUC_Hemsleya_chinensis_RNA
CUC_Hemsleya_chinensis_RNA__02	CUC_Hemsleya_chinensis_RNA
CUC_Hemsleya_chinensis_RNA__03	CUC_Hemsleya_chinensis_RNA
CUC_Hemsleya_chinensis_RNA__04	CUC_Hemsleya_chinensis_RNA
CUC_Hemsleya_chinensis_RNA__05	CUC_Hemsleya_chinensis_RNA
CUC_Hemsleya_macrosperma_RNA	CUC_Hemsleya_macrosperma_RNA
CUC_Hemsleya_macrosperma_RNA__00	CUC_Hemsleya_macrosperma_RNA
CUC_Hemsleya_macrosperma_RNA__01	CUC_Hemsleya_macrosperma_RNA
CUC_Hemsleya_macrosperma_RNA__02	CUC_Hemsleya_macrosperma_RNA
CUC_Hemsleya_macrosperma_RNA__03	CUC_Hemsleya_macrosperma_RNA
CUC_Hemsleya_macrosperma_RNA__04	CUC_Hemsleya_macrosperma_RNA
CUC_Hemsleya_macrosperma_RNA__05	CUC_Hemsleya_macrosperma_RNA
CUC_Herpetospermum_pedunculosum	CUC_Herpetospermum_pedunculosum
CUC_Herpetospermum_pedunculosum_RNA	CUC_Herpetospermum_pedunculosum_RNA
CUC_Herpetospermum_pedunculosum_RNA__00	CUC_Herpetospermum_pedunculosum_RNA
CUC_Herpetospermum_pedunculosum_RNA__01	CUC_Herpetospermum_pedunculosum_RNA
CUC_Herpetospermum_pedunculosum_RNA__02	CUC_Herpetospermum_pedunculosum_RNA
CUC_Herpetospermum_pedunculosum_RNA__03	CUC_Herpetospermum_pedunculosum_RNA
CUC_Herpetospermum_pedunculosum_RNA__04	CUC_Herpetospermum_pedunculosum_RNA
CUC_Herpetospermum_pedunculosum_RNA__05	CUC_Herpetospermum_pedunculosum_RNA
CUC_Herpetospermum_pedunculosum_SB13_GSK	CUC_Herpetospermum_pedunculosum_SB13_GSK
CUC_Herpetospermum_pedunculosum_SB13_GSK__00	CUC_Herpetospermum_pedunculosum_SB13_GSK
CUC_Herpetospermum_pedunculosum_SB13_GSK__01	CUC_Herpetospermum_pedunculosum_SB13_GSK
CUC_Herpetospermum_pedunculosum_SB13_GSK__02	CUC_Herpetospermum_pedunculosum_SB13_GSK
CUC_Herpetospermum_pedunculosum__00	CUC_Herpetospermum_pedunculosum
CUC_Herpetospermum_pedunculosum__01	CUC_Herpetospermum_pedunculosum
CUC_Herpetospermum_pedunculosum__02	CUC_Herpetospermum_pedunculosum
CUC_Herpetospermum_pedunculosum__03	CUC_Herpetospermum_pedunculosum
CUC_Herpetospermum_pedunculosum__04	CUC_Herpetospermum_pedunculosum
CUC_Herpetospermum_pedunculosum__05	CUC_Herpetospermum_pedunculosum
CUC_Hodgsonia_heteroclita_SYS034_GSK	CUC_Hodgsonia_heteroclita_SYS034_GSK
CUC_Hodgsonia_macrocarpa	CUC_Hodgsonia_macrocarpa
CUC_Hodgsonia_macrocarpa_HM3926_RNA	CUC_Hodgsonia_macrocarpa_HM3926_RNA
CUC_Hodgsonia_macrocarpa_HM3926_RNA__00	CUC_Hodgsonia_macrocarpa_HM3926_RNA
CUC_Hodgsonia_macrocarpa_HM3926_RNA__01	CUC_Hodgsonia_macrocarpa_HM3926_RNA
CUC_Hodgsonia_macrocarpa_HM3926_RNA__02	CUC_Hodgsonia_macrocarpa_HM3926_RNA
CUC_Hodgsonia_macrocarpa_HM3926_RNA__03	CUC_Hodgsonia_macrocarpa_HM3926_RNA
CUC_Hodgsonia_macrocarpa_HM3926_RNA__04	CUC_Hodgsonia_macrocarpa_HM3926_RNA
CUC_Hodgsonia_macrocarpa_HM3926_RNA__05	CUC_Hodgsonia_macrocarpa_HM3926_RNA
CUC_Hodgsonia_macrocarpa_RNA	CUC_Hodgsonia_macrocarpa_RNA
CUC_Hodgsonia_macrocarpa_RNA__00	CUC_Hodgsonia_macrocarpa_RNA
CUC_Hodgsonia_macrocarpa_RNA__01	CUC_Hodgsonia_macrocarpa_RNA
CUC_Hodgsonia_macrocarpa_RNA__02	CUC_Hodgsonia_macrocarpa_RNA
CUC_Hodgsonia_macrocarpa_RNA__03	CUC_Hodgsonia_macrocarpa_RNA
CUC_Hodgsonia_macrocarpa_RNA__04	CUC_Hodgsonia_macrocarpa_RNA
CUC_Hodgsonia_macrocarpa_RNA__05	CUC_Hodgsonia_macrocarpa_RNA
CUC_Hodgsonia_macrocarpa__00	CUC_Hodgsonia_macrocarpa
CUC_Hodgsonia_macrocarpa__01	CUC_Hodgsonia_macrocarpa
CUC_Ibervillea_maxima	CUC_Ibervillea_maxima
CUC_Ibervillea_maxima_HM3187_RNA	CUC_Ibervillea_maxima_HM3187_RNA
CUC_Ibervillea_maxima_HM3187_RNA__00	CUC_Ibervillea_maxima_HM3187_RNA
CUC_Ibervillea_maxima_HM3187_RNA__01	CUC_Ibervillea_maxima_HM3187_RNA
CUC_Ibervillea_maxima_HM3187_RNA__02	CUC_Ibervillea_maxima_HM3187_RNA
CUC_Ibervillea_maxima_HM3187_RNA__03	CUC_Ibervillea_maxima_HM3187_RNA
CUC_Ibervillea_maxima_HM3187_RNA__04	CUC_Ibervillea_maxima_HM3187_RNA
CUC_Ibervillea_maxima_HM3187_RNA__05	CUC_Ibervillea_maxima_HM3187_RNA
CUC_Ibervillea_maxima__00	CUC_Ibervillea_maxima
CUC_Ibervillea_maxima__01	CUC_Ibervillea_maxima
CUC_Ibervillea_maxima__02	CUC_Ibervillea_maxima
CUC_Ibervillea_maxima__03	CUC_Ibervillea_maxima
CUC_Ibervillea_maxima__04	CUC_Ibervillea_maxima
CUC_Ibervillea_maxima__05	CUC_Ibervillea_maxima
CUC_Ibervillea_sonorae_RNA	CUC_Ibervillea_sonorae_RNA
CUC_Ibervillea_sonorae_RNA__00	CUC_Ibervillea_sonorae_RNA
CUC_Ibervillea_sonorae_RNA__01	CUC_Ibervillea_sonorae_RNA
CUC_Ibervillea_sonorae_RNA__02	CUC_Ibervillea_sonorae_RNA
CUC_Ibervillea_sonorae_RNA__03	CUC_Ibervillea_sonorae_RNA
CUC_Ibervillea_sonorae_RNA__04	CUC_Ibervillea_sonorae_RNA
CUC_Ibervillea_sonorae_RNA__05	CUC_Ibervillea_sonorae_RNA
CUC_Ibervillea_tenuisecta_RNA	CUC_Ibervillea_tenuisecta_RNA
CUC_Ibervillea_tenuisecta_RNA__00	CUC_Ibervillea_tenuisecta_RNA
CUC_Ibervillea_tenuisecta_RNA__01	CUC_Ibervillea_tenuisecta_RNA
CUC_Ibervillea_tenuisecta_RNA__02	CUC_Ibervillea_tenuisecta_RNA
CUC_Ibervillea_tenuisecta_RNA__03	CUC_Ibervillea_tenuisecta_RNA
CUC_Ibervillea_tenuisecta_RNA__04	CUC_Ibervillea_tenuisecta_RNA
CUC_Ibervillea_tenuisecta_RNA__05	CUC_Ibervillea_tenuisecta_RNA
CUC_Indofevillea_khasiana	CUC_Indofevillea_khasiana
CUC_Indofevillea_khasiana_RNA	CUC_Indofevillea_khasiana_RNA
CUC_Indofevillea_khasiana_RNA__00	CUC_Indofevillea_khasiana_RNA
CUC_Indofevillea_khasiana_RNA__01	CUC_Indofevillea_khasiana_RNA
CUC_Indofevillea_khasiana_RNA__02	CUC_Indofevillea_khasiana_RNA
CUC_Indofevillea_khasiana_RNA__03	CUC_Indofevillea_khasiana_RNA
CUC_Indofevillea_khasiana_RNA__04	CUC_Indofevillea_khasiana_RNA
CUC_Indofevillea_khasiana_RNA__05	CUC_Indofevillea_khasiana_RNA
CUC_Indofevillea_khasiana_SYS066_GSK	CUC_Indofevillea_khasiana_SYS066_GSK
CUC_Indofevillea_khasiana_SYS066_GSK__00	CUC_Indofevillea_khasiana_SYS066_GSK
CUC_Indofevillea_khasiana_SYS066_GSK__01	CUC_Indofevillea_khasiana_SYS066_GSK
CUC_Indofevillea_khasiana_SYS066_GSK__02	CUC_Indofevillea_khasiana_SYS066_GSK
CUC_Indofevillea_khasiana_SYS066_GSK__03	CUC_Indofevillea_khasiana_SYS066_GSK
CUC_Indofevillea_khasiana_SYS066_GSK__04	CUC_Indofevillea_khasiana_SYS066_GSK
CUC_Indofevillea_khasiana_SYS066_GSK__05	CUC_Indofevillea_khasiana_SYS066_GSK
CUC_Indofevillea_khasiana__00	CUC_Indofevillea_khasiana
CUC_Indofevillea_khasiana__01	CUC_Indofevillea_khasiana
CUC_Indofevillea_khasiana__02	CUC_Indofevillea_khasiana
CUC_Indofevillea_khasiana__03	CUC_Indofevillea_khasiana
CUC_Indofevillea_khasiana__04	CUC_Indofevillea_khasiana
CUC_Indomelothria_chlorocarpa	CUC_Indomelothria_chlorocarpa
CUC_Indomelothria_chlorocarpa__00	CUC_Indomelothria_chlorocarpa
CUC_Indomelothria_chlorocarpa__01	CUC_Indomelothria_chlorocarpa
CUC_Indomelothria_chlorocarpa__02	CUC_Indomelothria_chlorocarpa
CUC_Indomelothria_chlorocarpa__03	CUC_Indomelothria_chlorocarpa
CUC_Kedrostis_africana	CUC_Kedrostis_africana
CUC_Kedrostis_africana_RNA	CUC_Kedrostis_africana_RNA
CUC_Kedrostis_africana_RNA__00	CUC_Kedrostis_africana_RNA
CUC_Kedrostis_africana_RNA__01	CUC_Kedrostis_africana_RNA
CUC_Kedrostis_africana_RNA__02	CUC_Kedrostis_africana_RNA
CUC_Kedrostis_africana_RNA__03	CUC_Kedrostis_africana_RNA
CUC_Kedrostis_africana_RNA__04	CUC_Kedrostis_africana_RNA
CUC_Kedrostis_africana_RNA__05	CUC_Kedrostis_africana_RNA
CUC_Kedrostis_africana__00	CUC_Kedrostis_africana
CUC_Kedrostis_africana__01	CUC_Kedrostis_africana
CUC_Kedrostis_bennettii	CUC_Kedrostis_bennettii
CUC_Kedrostis_bennettii__00	CUC_Kedrostis_bennettii
CUC_Kedrostis_bennettii__01	CUC_Kedrostis_bennettii
CUC_Kedrostis_bennettii__02	CUC_Kedrostis_bennettii
CUC_Kedrostis_bennettii__03	CUC_Kedrostis_bennettii
CUC_Kedrostis_elongata	CUC_Kedrostis_elongata
CUC_Kedrostis_elongata__00	CUC_Kedrostis_elongata
CUC_Kedrostis_elongata__01	CUC_Kedrostis_elongata
CUC_Kedrostis_elongata__02	CUC_Kedrostis_elongata
CUC_Kedrostis_nana	CUC_Kedrostis_nana
CUC_Kedrostis_nana_RNA	CUC_Kedrostis_nana_RNA
CUC_Kedrostis_nana_RNA__00	CUC_Kedrostis_nana_RNA
CUC_Kedrostis_nana_RNA__01	CUC_Kedrostis_nana_RNA
CUC_Kedrostis_nana_RNA__02	CUC_Kedrostis_nana_RNA
CUC_Kedrostis_nana_RNA__03	CUC_Kedrostis_nana_RNA
CUC_Kedrostis_nana_RNA__04	CUC_Kedrostis_nana_RNA
CUC_Kedrostis_nana_RNA__05	CUC_Kedrostis_nana_RNA
CUC_Kedrostis_nana__00	CUC_Kedrostis_nana
CUC_Kedrostis_nana__01	CUC_Kedrostis_nana
CUC_Kedrostis_nana__02	CUC_Kedrostis_nana
CUC_Kedrostis_nana__03	CUC_Kedrostis_nana
CUC_Kedrostis_nana__04	CUC_Kedrostis_nana
CUC_Kedrostis_nana__05	CUC_Kedrostis_nana
CUC_Kedrostis_pseudogijef	CUC_Kedrostis_pseudogijef
CUC_Kedrostis_pseudogijef__00	CUC_Kedrostis_pseudogijef
CUC_Kedrostis_pseudogijef__01	CUC_Kedrostis_pseudogijef
CUC_Kedrostis_pseudogijef__02	CUC_Kedrostis_pseudogijef
CUC_Kedrostis_pseudogijef__03	CUC_Kedrostis_pseudogijef
CUC_Kedrostis_pseudogijef__04	CUC_Kedrostis_pseudogijef
CUC_Kedrostis_pseudogijef__05	CUC_Kedrostis_pseudogijef
CUC_Khmeriosicyos_harmandii	CUC_Khmeriosicyos_harmandii
CUC_Khmeriosicyos_harmandii__00	CUC_Khmeriosicyos_harmandii
CUC_Khmeriosicyos_harmandii__01	CUC_Khmeriosicyos_harmandii
CUC_Khmeriosicyos_harmandii__02	CUC_Khmeriosicyos_harmandii
CUC_Lagenaria_siceraria_GJ113_RNA	CUC_Lagenaria_siceraria_GJ113_RNA
CUC_Lagenaria_siceraria_GJ113_RNA__00	CUC_Lagenaria_siceraria_GJ113_RNA
CUC_Lagenaria_siceraria_GJ113_RNA__01	CUC_Lagenaria_siceraria_GJ113_RNA
CUC_Lagenaria_siceraria_GJ113_RNA__02	CUC_Lagenaria_siceraria_GJ113_RNA
CUC_Lagenaria_siceraria_GJ113_RNA__03	CUC_Lagenaria_siceraria_GJ113_RNA
CUC_Lagenaria_siceraria_GJ113_RNA__04	CUC_Lagenaria_siceraria_GJ113_RNA
CUC_Lagenaria_siceraria_GJ113_RNA__05	CUC_Lagenaria_siceraria_GJ113_RNA
CUC_Lagenaria_siceraria_var_hispida_RNA	CUC_Lagenaria_siceraria_var_hispida_RNA
CUC_Lagenaria_siceraria_var_hispida_RNA__00	CUC_Lagenaria_siceraria_var_hispida_RNA
CUC_Lagenaria_siceraria_var_hispida_RNA__01	CUC_Lagenaria_siceraria_var_hispida_RNA
CUC_Lagenaria_siceraria_var_hispida_RNA__02	CUC_Lagenaria_siceraria_var_hispida_RNA
CUC_Lagenaria_siceraria_var_hispida_RNA__03	CUC_Lagenaria_siceraria_var_hispida_RNA
CUC_Lagenaria_siceraria_var_hispida_RNA__04	CUC_Lagenaria_siceraria_var_hispida_RNA
CUC_Lagenaria_siceraria_var_hispida_RNA__05	CUC_Lagenaria_siceraria_var_hispida_RNA
CUC_Lagenaria_siceraria_var_microcarpa_RNA	CUC_Lagenaria_siceraria_var_microcarpa_RNA
CUC_Lagenaria_siceraria_var_microcarpa_RNA__00	CUC_Lagenaria_siceraria_var_microcarpa_RNA
CUC_Lagenaria_siceraria_var_microcarpa_RNA__01	CUC_Lagenaria_siceraria_var_microcarpa_RNA
CUC_Lagenaria_siceraria_var_microcarpa_RNA__02	CUC_Lagenaria_siceraria_var_microcarpa_RNA
CUC_Lagenaria_siceraria_var_microcarpa_RNA__03	CUC_Lagenaria_siceraria_var_microcarpa_RNA
CUC_Lagenaria_siceraria_var_microcarpa_RNA__04	CUC_Lagenaria_siceraria_var_microcarpa_RNA
CUC_Lagenaria_siceraria_var_siceraria_WGS	CUC_Lagenaria_siceraria_var_siceraria_WGS
CUC_Lagenaria_siceraria_var_siceraria_WGS__00	CUC_Lagenaria_siceraria_var_siceraria_WGS
CUC_Lagenaria_siceraria_var_siceraria_WGS__01	CUC_Lagenaria_siceraria_var_siceraria_WGS
CUC_Lagenaria_siceraria_var_siceraria_WGS__02	CUC_Lagenaria_siceraria_var_siceraria_WGS
CUC_Lemurosicyos_variegata	CUC_Lemurosicyos_variegata
CUC_Lemurosicyos_variegata_HS0262_WGS	CUC_Lemurosicyos_variegata_HS0262_WGS
CUC_Lemurosicyos_variegata_HS0262_WGS__00	CUC_Lemurosicyos_variegata_HS0262_WGS
CUC_Lemurosicyos_variegata_HS0262_WGS__01	CUC_Lemurosicyos_variegata_HS0262_WGS
CUC_Lemurosicyos_variegata_HS0262_WGS__02	CUC_Lemurosicyos_variegata_HS0262_WGS
CUC_Lemurosicyos_variegata_HS0262_WGS__03	CUC_Lemurosicyos_variegata_HS0262_WGS
CUC_Lemurosicyos_variegata__00	CUC_Lemurosicyos_variegata
CUC_Lemurosicyos_variegata__01	CUC_Lemurosicyos_variegata
CUC_Linnaeosicyos_amara	CUC_Linnaeosicyos_amara
CUC_Linnaeosicyos_amara_SYS507_GSK	CUC_Linnaeosicyos_amara_SYS507_GSK
CUC_Linnaeosicyos_amara_SYS507_GSK__00	CUC_Linnaeosicyos_amara_SYS507_GSK
CUC_Linnaeosicyos_amara_SYS507_GSK__01	CUC_Linnaeosicyos_amara_SYS507_GSK
CUC_Linnaeosicyos_amara_SYS507_GSK__02	CUC_Linnaeosicyos_amara_SYS507_GSK
CUC_Linnaeosicyos_amara__00	CUC_Linnaeosicyos_amara
CUC_Linnaeosicyos_amara__01	CUC_Linnaeosicyos_amara
CUC_Linnaeosicyos_amara__02	CUC_Linnaeosicyos_amara
CUC_Luffa_acutangula_RNA	CUC_Luffa_acutangula_RNA
CUC_Luffa_acutangula_RNA__00	CUC_Luffa_acutangula_RNA
CUC_Luffa_acutangula_RNA__01	CUC_Luffa_acutangula_RNA
CUC_Luffa_acutangula_RNA__02	CUC_Luffa_acutangula_RNA
CUC_Luffa_aegyptiaca_RNA	CUC_Luffa_aegyptiaca_RNA
CUC_Luffa_aegyptiaca_RNA__00	CUC_Luffa_aegyptiaca_RNA
CUC_Luffa_aegyptiaca_RNA__01	CUC_Luffa_aegyptiaca_RNA
CUC_Luffa_aegyptiaca_RNA__02	CUC_Luffa_aegyptiaca_RNA
CUC_Luffa_aegyptiaca_SYS018_GSK	CUC_Luffa_aegyptiaca_SYS018_GSK
CUC_Luffa_aegyptiaca_SYS018_GSK__00	CUC_Luffa_aegyptiaca_SYS018_GSK
CUC_Luffa_aegyptiaca_SYS018_GSK__01	CUC_Luffa_aegyptiaca_SYS018_GSK
CUC_Luffa_aegyptiaca_SYS018_GSK__02	CUC_Luffa_aegyptiaca_SYS018_GSK
CUC_Luffa_sepium	CUC_Luffa_sepium
CUC_Luffa_sepium__00	CUC_Luffa_sepium
CUC_Luffa_sepium__01	CUC_Luffa_sepium
CUC_Luffa_sepium__02	CUC_Luffa_sepium
CUC_Luffa_sepium__03	CUC_Luffa_sepium
CUC_Luffa_sepium__04	CUC_Luffa_sepium
CUC_Luffa_sepium__05	CUC_Luffa_sepium
CUC_Marah_fabacea	CUC_Marah_fabacea
CUC_Marah_fabacea_RNA	CUC_Marah_fabacea_RNA
CUC_Marah_fabacea_RNA__00	CUC_Marah_fabacea_RNA
CUC_Marah_fabacea_RNA__01	CUC_Marah_fabacea_RNA
CUC_Marah_fabacea_RNA__02	CUC_Marah_fabacea_RNA
CUC_Marah_fabacea_RNA__03	CUC_Marah_fabacea_RNA
CUC_Marah_fabacea_RNA__04	CUC_Marah_fabacea_RNA
CUC_Marah_fabacea_RNA__05	CUC_Marah_fabacea_RNA
CUC_Marah_fabacea__00	CUC_Marah_fabacea
CUC_Marah_fabacea__01	CUC_Marah_fabacea
CUC_Marah_fabacea__02	CUC_Marah_fabacea
CUC_Marah_fabacea__03	CUC_Marah_fabacea
CUC_Marah_fabacea__04	CUC_Marah_fabacea
CUC_Marah_fabacea__05	CUC_Marah_fabacea
CUC_Marah_macrocarpa_RNA	CUC_Marah_macrocarpa_RNA
CUC_Marah_macrocarpa_RNA__00	CUC_Marah_macrocarpa_RNA
CUC_Marah_macrocarpa_RNA__01	CUC_Marah_macrocarpa_RNA
CUC_Marah_macrocarpa_RNA__02	CUC_Marah_macrocarpa_RNA
CUC_Marah_macrocarpa_RNA__03	CUC_Marah_macrocarpa_RNA
CUC_Marah_macrocarpa_RNA__04	CUC_Marah_macrocarpa_RNA
CUC_Marah_macrocarpa_RNA__05	CUC_Marah_macrocarpa_RNA
CUC_Melothria_campestris	CUC_Melothria_campestris
CUC_Melothria_campestris__00	CUC_Melothria_campestris
CUC_Melothria_campestris__01	CUC_Melothria_campestris
CUC_Melothria_pendula	CUC_Melothria_pendula
CUC_Melothria_pendula_RNA	CUC_Melothria_pendula_RNA
CUC_Melothria_pendula_RNA__00	CUC_Melothria_pendula_RNA
CUC_Melothria_pendula_RNA__01	CUC_Melothria_pendula_RNA
CUC_Melothria_pendula_RNA__02	CUC_Melothria_pendula_RNA
CUC_Melothria_pendula_RNA__03	CUC_Melothria_pendula_RNA
CUC_Melothria_pendula__00	CUC_Melothria_pendula
CUC_Melothria_pendula__01	CUC_Melothria_pendula
CUC_Melothria_pendula__02	CUC_Melothria_pendula
CUC_Melothria_sphaerocarpa_RNA	CUC_Melothria_sphaerocarpa_RNA
CUC_Melothria_sphaerocarpa_RNA__00	CUC_Melothria_sphaerocarpa_RNA
CUC_Melothria_sphaerocarpa_RNA__01	CUC_Melothria_sphaerocarpa_RNA
CUC_Melothria_sphaerocarpa_RNA__02	CUC_Melothria_sphaerocarpa_RNA
CUC_Melothria_sphaerocarpa_RNA__03	CUC_Melothria_sphaerocarpa_RNA
CUC_Melothria_sphaerocarpa_RNA__04	CUC_Melothria_sphaerocarpa_RNA
CUC_Melothria_sphaerocarpa_RNA__05	CUC_Melothria_sphaerocarpa_RNA
CUC_Melothrianthus_argenteus	CUC_Melothrianthus_argenteus
CUC_Melothrianthus_argenteus__00	CUC_Melothrianthus_argenteus
CUC_Melothrianthus_argenteus__01	CUC_Melothrianthus_argenteus
CUC_Melothrianthus_argenteus__02	CUC_Melothrianthus_argenteus
CUC_Melothrianthus_argenteus__03	CUC_Melothrianthus_argenteus
CUC_Melothrianthus_argenteus__04	CUC_Melothrianthus_argenteus
CUC_Melothrianthus_sagittifolius_RNA	CUC_Melothrianthus_sagittifolius_RNA
CUC_Melothrianthus_sagittifolius_RNA__00	CUC_Melothrianthus_sagittifolius_RNA
CUC_Melothrianthus_sagittifolius_RNA__01	CUC_Melothrianthus_sagittifolius_RNA
CUC_Melothrianthus_sagittifolius_RNA__02	CUC_Melothrianthus_sagittifolius_RNA
CUC_Microsechium_helleri	CUC_Microsechium_helleri
CUC_Microsechium_helleri__00	CUC_Microsechium_helleri
CUC_Microsechium_helleri__01	CUC_Microsechium_helleri
CUC_Microsechium_helleri__02	CUC_Microsechium_helleri
CUC_Microsechium_helleri__03	CUC_Microsechium_helleri
CUC_Momordica_balsamina_GSK	CUC_Momordica_balsamina_GSK
CUC_Momordica_balsamina_GSK__00	CUC_Momordica_balsamina_GSK
CUC_Momordica_balsamina_GSK__01	CUC_Momordica_balsamina_GSK
CUC_Momordica_balsamina_GSK__02	CUC_Momordica_balsamina_GSK
CUC_Momordica_balsamina_GSK__03	CUC_Momordica_balsamina_GSK
CUC_Momordica_boivinii_RNA	CUC_Momordica_boivinii_RNA
CUC_Momordica_boivinii_RNA__00	CUC_Momordica_boivinii_RNA
CUC_Momordica_boivinii_RNA__01	CUC_Momordica_boivinii_RNA
CUC_Momordica_boivinii_RNA__02	CUC_Momordica_boivinii_RNA
CUC_Momordica_boivinii_RNA__03	CUC_Momordica_boivinii_RNA
CUC_Momordica_boivinii_RNA__04	CUC_Momordica_boivinii_RNA
CUC_Momordica_cardiospermoides_RNA	CUC_Momordica_cardiospermoides_RNA
CUC_Momordica_cardiospermoides_RNA__00	CUC_Momordica_cardiospermoides_RNA
CUC_Momordica_cardiospermoides_RNA__01	CUC_Momordica_cardiospermoides_RNA
CUC_Momordica_cardiospermoides_RNA__02	CUC_Momordica_cardiospermoides_RNA
CUC_Momordica_cardiospermoides_RNA__03	CUC_Momordica_cardiospermoides_RNA
CUC_Momordica_cardiospermoides_RNA__04	CUC_Momordica_cardiospermoides_RNA
CUC_Momordica_charantia_RNA	CUC_Momordica_charantia_RNA
CUC_Momordica_charantia_RNA__00	CUC_Momordica_charantia_RNA
CUC_Momordica_charantia_RNA__01	CUC_Momordica_charantia_RNA
CUC_Momordica_charantia_RNA__02	CUC_Momordica_charantia_RNA
CUC_Momordica_charantia_RNA__03	CUC_Momordica_charantia_RNA
CUC_Momordica_charantia_RNA__04	CUC_Momordica_charantia_RNA
CUC_Momordica_charantia_RNA__05	CUC_Momordica_charantia_RNA
CUC_Momordica_charantia_var_abbreviata_RNA	CUC_Momordica_charantia_var_abbreviata_RNA
CUC_Momordica_charantia_var_abbreviata_RNA__00	CUC_Momordica_charantia_var_abbreviata_RNA
CUC_Momordica_charantia_var_abbreviata_RNA__01	CUC_Momordica_charantia_var_abbreviata_RNA
CUC_Momordica_charantia_var_abbreviata_RNA__02	CUC_Momordica_charantia_var_abbreviata_RNA
CUC_Momordica_charantia_var_abbreviata_RNA__03	CUC_Momordica_charantia_var_abbreviata_RNA
CUC_Momordica_charantia_var_abbreviata_RNA__04	CUC_Momordica_charantia_var_abbreviata_RNA
CUC_Momordica_charantia_var_abbreviata_RNA__05	CUC_Momordica_charantia_var_abbreviata_RNA
CUC_Momordica_charantia_var_charantia_RNA	CUC_Momordica_charantia_var_charantia_RNA
CUC_Momordica_charantia_var_charantia_RNA__00	CUC_Momordica_charantia_var_charantia_RNA
CUC_Momordica_charantia_var_charantia_RNA__01	CUC_Momordica_charantia_var_charantia_RNA
CUC_Momordica_charantia_var_charantia_RNA__02	CUC_Momordica_charantia_var_charantia_RNA
CUC_Momordica_charantia_var_charantia_RNA__03	CUC_Momordica_charantia_var_charantia_RNA
CUC_Momordica_charantia_var_charantia_RNA__04	CUC_Momordica_charantia_var_charantia_RNA
CUC_Momordica_charantia_var_charantia_RNA__05	CUC_Momordica_charantia_var_charantia_RNA
CUC_Momordica_cochinchinensis_RNA	CUC_Momordica_cochinchinensis_RNA
CUC_Momordica_cochinchinensis_RNA__00	CUC_Momordica_cochinchinensis_RNA
CUC_Momordica_cochinchinensis_RNA__01	CUC_Momordica_cochinchinensis_RNA
CUC_Momordica_cochinchinensis_RNA__02	CUC_Momordica_cochinchinensis_RNA
CUC_Momordica_cochinchinensis_RNA__03	CUC_Momordica_cochinchinensis_RNA
CUC_Momordica_cochinchinensis_RNA__04	CUC_Momordica_cochinchinensis_RNA
CUC_Momordica_cochinchinensis_RNA__05	CUC_Momordica_cochinchinensis_RNA
CUC_Momordica_foetida_GSK	CUC_Momordica_foetida_GSK
CUC_Momordica_foetida_GSK__00	CUC_Momordica_foetida_GSK
CUC_Momordica_foetida_GSK__01	CUC_Momordica_foetida_GSK
CUC_Momordica_foetida_GSK__02	CUC_Momordica_foetida_GSK
CUC_Momordica_foetida_RNA	CUC_Momordica_foetida_RNA
CUC_Momordica_foetida_RNA__00	CUC_Momordica_foetida_RNA
CUC_Momordica_foetida_RNA__01	CUC_Momordica_foetida_RNA
CUC_Momordica_foetida_RNA__02	CUC_Momordica_foetida_RNA
CUC_Momordica_foetida_RNA__03	CUC_Momordica_foetida_RNA
CUC_Momordica_foetida_RNA__04	CUC_Momordica_foetida_RNA
CUC_Momordica_peteri	CUC_Momordica_peteri
CUC_Momordica_peteri__00	CUC_Momordica_peteri
CUC_Momordica_peteri__01	CUC_Momordica_peteri
CUC_Momordica_rostrata_RNA	CUC_Momordica_rostrata_RNA
CUC_Momordica_rostrata_RNA__00	CUC_Momordica_rostrata_RNA
CUC_Momordica_rostrata_RNA__01	CUC_Momordica_rostrata_RNA
CUC_Momordica_rostrata_RNA__02	CUC_Momordica_rostrata_RNA
CUC_Momordica_rostrata_RNA__03	CUC_Momordica_rostrata_RNA
CUC_Momordica_rostrata_RNA__04	CUC_Momordica_rostrata_RNA
CUC_Momordica_rostrata_RNA__05	CUC_Momordica_rostrata_RNA
CUC_Momordica_sessilifolia_HS2565_GSK	CUC_Momordica_sessilifolia_HS2565_GSK
CUC_Momordica_sessilifolia_HS2565_GSK__00	CUC_Momordica_sessilifolia_HS2565_GSK
CUC_Momordica_sessilifolia_HS2565_GSK__01	CUC_Momordica_sessilifolia_HS2565_GSK
CUC_Momordica_sessilifolia_HS2565_GSK__02	CUC_Momordica_sessilifolia_HS2565_GSK
CUC_Momordica_sessilifolia_HS2565_GSK__03	CUC_Momordica_sessilifolia_HS2565_GSK
CUC_Muellerargia_timorensis	CUC_Muellerargia_timorensis
CUC_Muellerargia_timorensis__00	CUC_Muellerargia_timorensis
CUC_Muellerargia_timorensis__01	CUC_Muellerargia_timorensis
CUC_Muellerargia_timorensis__02	CUC_Muellerargia_timorensis
CUC_Muellerargia_timorensis__03	CUC_Muellerargia_timorensis
CUC_Muellerargia_timorensis__04	CUC_Muellerargia_timorensis
CUC_Muellerargia_timorensis__05	CUC_Muellerargia_timorensis
CUC_Neoalsomitra_integrifoliola_RNA	CUC_Neoalsomitra_integrifoliola_RNA
CUC_Neoalsomitra_integrifoliola_RNA__00	CUC_Neoalsomitra_integrifoliola_RNA
CUC_Neoalsomitra_integrifoliola_RNA__01	CUC_Neoalsomitra_integrifoliola_RNA
CUC_Neoalsomitra_integrifoliola_RNA__02	CUC_Neoalsomitra_integrifoliola_RNA
CUC_Neoalsomitra_integrifoliola_RNA__03	CUC_Neoalsomitra_integrifoliola_RNA
CUC_Neoalsomitra_integrifoliola_RNA__04	CUC_Neoalsomitra_integrifoliola_RNA
CUC_Neoalsomitra_integrifoliola_RNA__05	CUC_Neoalsomitra_integrifoliola_RNA
CUC_Neoalsomitra_sarcophylla	CUC_Neoalsomitra_sarcophylla
CUC_Neoalsomitra_sarcophylla_RNA	CUC_Neoalsomitra_sarcophylla_RNA
CUC_Neoalsomitra_sarcophylla_RNA__00	CUC_Neoalsomitra_sarcophylla_RNA
CUC_Neoalsomitra_sarcophylla_RNA__01	CUC_Neoalsomitra_sarcophylla_RNA
CUC_Neoalsomitra_sarcophylla_RNA__02	CUC_Neoalsomitra_sarcophylla_RNA
CUC_Neoalsomitra_sarcophylla_RNA__03	CUC_Neoalsomitra_sarcophylla_RNA
CUC_Neoalsomitra_sarcophylla_RNA__04	CUC_Neoalsomitra_sarcophylla_RNA
CUC_Neoalsomitra_sarcophylla_RNA__05	CUC_Neoalsomitra_sarcophylla_RNA
CUC_Neoalsomitra_sarcophylla__00	CUC_Neoalsomitra_sarcophylla
CUC_Neoalsomitra_sarcophylla__01	CUC_Neoalsomitra_sarcophylla
CUC_Neoalsomitra_sarcophylla__02	CUC_Neoalsomitra_sarcophylla
CUC_Neoalsomitra_sarcophylla__03	CUC_Neoalsomitra_sarcophylla
CUC_Nothoalsomitra_suberosa	CUC_Nothoalsomitra_suberosa
CUC_Nothoalsomitra_suberosa_SB27_GSK	CUC_Nothoalsomitra_suberosa_SB27_GSK
CUC_Nothoalsomitra_suberosa_SB27_GSK__00	CUC_Nothoalsomitra_suberosa_SB27_GSK
CUC_Nothoalsomitra_suberosa_SB27_GSK__01	CUC_Nothoalsomitra_suberosa_SB27_GSK
CUC_Nothoalsomitra_suberosa__00	CUC_Nothoalsomitra_suberosa
CUC_Nothoalsomitra_suberosa__01	CUC_Nothoalsomitra_suberosa
CUC_Nothoalsomitra_suberosa__02	CUC_Nothoalsomitra_suberosa
CUC_Nothoalsomitra_suberosa__03	CUC_Nothoalsomitra_suberosa
CUC_Papuasicyos_sp	CUC_Papuasicyos_sp
CUC_Papuasicyos_sp__00	CUC_Papuasicyos_sp
CUC_Papuasicyos_sp__01	CUC_Papuasicyos_sp
CUC_Penelopeia_sphaerica	CUC_Penelopeia_sphaerica
CUC_Penelopeia_sphaerica__00	CUC_Penelopeia_sphaerica
CUC_Penelopeia_sphaerica__01	CUC_Penelopeia_sphaerica
CUC_Penelopeia_sphaerica__02	CUC_Penelopeia_sphaerica
CUC_Penelopeia_sphaerica__03	CUC_Penelopeia_sphaerica
CUC_Peponium_poissonii	CUC_Peponium_poissonii
CUC_Peponium_poissonii__00	CUC_Peponium_poissonii
CUC_Peponium_poissonii__01	CUC_Peponium_poissonii
CUC_Peponium_poissonii__02	CUC_Peponium_poissonii
CUC_Peponium_poissonii__03	CUC_Peponium_poissonii
CUC_Peponium_poissonii__04	CUC_Peponium_poissonii
CUC_Peponium_poissonii__05	CUC_Peponium_poissonii
CUC_Peponium_vogelii_RNA	CUC_Peponium_vogelii_RNA
CUC_Peponium_vogelii_RNA__00	CUC_Peponium_vogelii_RNA
CUC_Peponium_vogelii_RNA__01	CUC_Peponium_vogelii_RNA
CUC_Peponium_vogelii_RNA__02	CUC_Peponium_vogelii_RNA
CUC_Peponium_vogelii_RNA__03	CUC_Peponium_vogelii_RNA
CUC_Peponium_vogelii_RNA__04	CUC_Peponium_vogelii_RNA
CUC_Peponopsis_adhaerens	CUC_Peponopsis_adhaerens
CUC_Peponopsis_adhaerens__00	CUC_Peponopsis_adhaerens
CUC_Peponopsis_adhaerens__01	CUC_Peponopsis_adhaerens
CUC_Peponopsis_adhaerens__02	CUC_Peponopsis_adhaerens
CUC_Peponopsis_adhaerens__03	CUC_Peponopsis_adhaerens
CUC_Peponopsis_adhaerens__04	CUC_Peponopsis_adhaerens
CUC_Polyclathra_cucumerina	CUC_Polyclathra_cucumerina
CUC_Polyclathra_cucumerina__00	CUC_Polyclathra_cucumerina
CUC_Polyclathra_cucumerina__01	CUC_Polyclathra_cucumerina
CUC_Polyclathra_cucumerina__02	CUC_Polyclathra_cucumerina
CUC_Polyclathra_cucumerina__03	CUC_Polyclathra_cucumerina
CUC_Polyclathra_cucumerina__04	CUC_Polyclathra_cucumerina
CUC_Polyclathra_cucumerina__05	CUC_Polyclathra_cucumerina
CUC_Pseudoapodanthera_villosa	CUC_Pseudoapodanthera_villosa
CUC_Pseudoapodanthera_villosa__00	CUC_Pseudoapodanthera_villosa
CUC_Pseudoapodanthera_villosa__01	CUC_Pseudoapodanthera_villosa
CUC_Pseudoapodanthera_villosa__02	CUC_Pseudoapodanthera_villosa
CUC_Pseudoapodanthera_villosa__03	CUC_Pseudoapodanthera_villosa
CUC_Pseudoapodanthera_villosa__04	CUC_Pseudoapodanthera_villosa
CUC_Psiguria_pedata	CUC_Psiguria_pedata
CUC_Psiguria_pedata__00	CUC_Psiguria_pedata
CUC_Psiguria_pedata__01	CUC_Psiguria_pedata
CUC_Psiguria_pedata__02	CUC_Psiguria_pedata
CUC_Psiguria_pedata__03	CUC_Psiguria_pedata
CUC_Psiguria_pedata__04	CUC_Psiguria_pedata
CUC_Psiguria_pedata__05	CUC_Psiguria_pedata
CUC_Psiguria_triphylla_RNA	CUC_Psiguria_triphylla_RNA
CUC_Psiguria_triphylla_RNA__00	CUC_Psiguria_triphylla_RNA
CUC_Psiguria_triphylla_RNA__01	CUC_Psiguria_triphylla_RNA
CUC_Psiguria_triphylla_RNA__02	CUC_Psiguria_triphylla_RNA
CUC_Psiguria_triphylla_RNA__03	CUC_Psiguria_triphylla_RNA
CUC_Psiguria_triphylla_RNA__04	CUC_Psiguria_triphylla_RNA
CUC_Psiguria_triphylla_RNA__05	CUC_Psiguria_triphylla_RNA
CUC_Pteropepon_deltoideus	CUC_Pteropepon_deltoideus
CUC_Pteropepon_deltoideus__00	CUC_Pteropepon_deltoideus
CUC_Pteropepon_deltoideus__01	CUC_Pteropepon_deltoideus
CUC_Pteropepon_deltoideus__02	CUC_Pteropepon_deltoideus
CUC_Raphidiocystis_welwitschii_HS5553_WGS	CUC_Raphidiocystis_welwitschii_HS5553_WGS
CUC_Raphidiocystis_welwitschii_HS5553_WGS__00	CUC_Raphidiocystis_welwitschii_HS5553_WGS
CUC_Raphidiocystis_welwitschii_HS5553_WGS__01	CUC_Raphidiocystis_welwitschii_HS5553_WGS
CUC_Raphidiocystis_welwitschii_HS5553_WGS__02	CUC_Raphidiocystis_welwitschii_HS5553_WGS
CUC_Raphidiocystis_welwitschii_HS5553_WGS__03	CUC_Raphidiocystis_welwitschii_HS5553_WGS
CUC_Ruthalicia_eglandulosa	CUC_Ruthalicia_eglandulosa
CUC_Ruthalicia_eglandulosa__00	CUC_Ruthalicia_eglandulosa
CUC_Ruthalicia_eglandulosa__01	CUC_Ruthalicia_eglandulosa
CUC_Ruthalicia_eglandulosa__02	CUC_Ruthalicia_eglandulosa
CUC_Rytidostylis_longisepala	CUC_Rytidostylis_longisepala
CUC_Rytidostylis_longisepala__00	CUC_Rytidostylis_longisepala
CUC_Rytidostylis_longisepala__01	CUC_Rytidostylis_longisepala
CUC_Rytidostylis_longisepala__02	CUC_Rytidostylis_longisepala
CUC_Rytidostylis_longisepala__03	CUC_Rytidostylis_longisepala
CUC_Rytidostylis_longisepala__04	CUC_Rytidostylis_longisepala
CUC_Schizocarpum_filiforme	CUC_Schizocarpum_filiforme
CUC_Schizocarpum_filiforme__00	CUC_Schizocarpum_filiforme
CUC_Schizocarpum_filiforme__01	CUC_Schizocarpum_filiforme
CUC_Schizocarpum_filiforme__02	CUC_Schizocarpum_filiforme
CUC_Schizocarpum_filiforme__03	CUC_Schizocarpum_filiforme
CUC_Schizocarpum_filiforme__04	CUC_Schizocarpum_filiforme
CUC_Schizopepon_bryoniifolius	CUC_Schizopepon_bryoniifolius
CUC_Schizopepon_bryoniifolius_RNA	CUC_Schizopepon_bryoniifolius_RNA
CUC_Schizopepon_bryoniifolius_RNA__00	CUC_Schizopepon_bryoniifolius_RNA
CUC_Schizopepon_bryoniifolius_RNA__01	CUC_Schizopepon_bryoniifolius_RNA
CUC_Schizopepon_bryoniifolius_RNA__02	CUC_Schizopepon_bryoniifolius_RNA
CUC_Schizopepon_bryoniifolius_RNA__03	CUC_Schizopepon_bryoniifolius_RNA
CUC_Schizopepon_bryoniifolius_RNA__04	CUC_Schizopepon_bryoniifolius_RNA
CUC_Schizopepon_bryoniifolius_RNA__05	CUC_Schizopepon_bryoniifolius_RNA
CUC_Schizopepon_bryoniifolius__00	CUC_Schizopepon_bryoniifolius
CUC_Schizopepon_bryoniifolius__01	CUC_Schizopepon_bryoniifolius
CUC_Schizopepon_bryoniifolius__02	CUC_Schizopepon_bryoniifolius
CUC_Schizopepon_bryoniifolius__03	CUC_Schizopepon_bryoniifolius
CUC_Schizopepon_bryoniifolius__04	CUC_Schizopepon_bryoniifolius
CUC_Schizopepon_bryoniifolius__05	CUC_Schizopepon_bryoniifolius
CUC_Schizopepon_monoicus_RNA	CUC_Schizopepon_monoicus_RNA
CUC_Schizopepon_monoicus_RNA__00	CUC_Schizopepon_monoicus_RNA
CUC_Schizopepon_monoicus_RNA__01	CUC_Schizopepon_monoicus_RNA
CUC_Schizopepon_monoicus_RNA__02	CUC_Schizopepon_monoicus_RNA
CUC_Schizopepon_monoicus_RNA__03	CUC_Schizopepon_monoicus_RNA
CUC_Schizopepon_monoicus_RNA__04	CUC_Schizopepon_monoicus_RNA
CUC_Schizopepon_monoicus_RNA__05	CUC_Schizopepon_monoicus_RNA
CUC_Scopellaria_diversifolia	CUC_Scopellaria_diversifolia
CUC_Scopellaria_diversifolia__00	CUC_Scopellaria_diversifolia
CUC_Scopellaria_diversifolia__01	CUC_Scopellaria_diversifolia
CUC_Scopellaria_diversifolia__02	CUC_Scopellaria_diversifolia
CUC_Scopellaria_diversifolia__03	CUC_Scopellaria_diversifolia
CUC_Scopellaria_diversifolia__04	CUC_Scopellaria_diversifolia
CUC_Scopellaria_diversifolia__05	CUC_Scopellaria_diversifolia
CUC_Seyrigia_gracilis	CUC_Seyrigia_gracilis
CUC_Seyrigia_gracilis__00	CUC_Seyrigia_gracilis
CUC_Seyrigia_gracilis__01	CUC_Seyrigia_gracilis
CUC_Seyrigia_gracilis__02	CUC_Seyrigia_gracilis
CUC_Seyrigia_gracilis__03	CUC_Seyrigia_gracilis
CUC_Seyrigia_gracilis__04	CUC_Seyrigia_gracilis
CUC_Seyrigia_gracilis__05	CUC_Seyrigia_gracilis
CUC_Seyrigia_humbertii_RNA	CUC_Seyrigia_humbertii_RNA
CUC_Seyrigia_humbertii_RNA__00	CUC_Seyrigia_humbertii_RNA
CUC_Seyrigia_humbertii_RNA__01	CUC_Seyrigia_humbertii_RNA
CUC_Seyrigia_humbertii_RNA__02	CUC_Seyrigia_humbertii_RNA
CUC_Seyrigia_humbertii_RNA__03	CUC_Seyrigia_humbertii_RNA
CUC_Seyrigia_humbertii_RNA__04	CUC_Seyrigia_humbertii_RNA
CUC_Seyrigia_humbertii_RNA__05	CUC_Seyrigia_humbertii_RNA
CUC_Sicana_odorifera	CUC_Sicana_odorifera
CUC_Sicana_odorifera_RNA	CUC_Sicana_odorifera_RNA
CUC_Sicana_odorifera_RNA__00	CUC_Sicana_odorifera_RNA
CUC_Sicana_odorifera_RNA__01	CUC_Sicana_odorifera_RNA
CUC_Sicana_odorifera_RNA__02	CUC_Sicana_odorifera_RNA
CUC_Sicana_odorifera_RNA__03	CUC_Sicana_odorifera_RNA
CUC_Sicana_odorifera_RNA__04	CUC_Sicana_odorifera_RNA
CUC_Sicana_odorifera_RNA__05	CUC_Sicana_odorifera_RNA
CUC_Sicana_odorifera__00	CUC_Sicana_odorifera
CUC_Sicana_odorifera__01	CUC_Sicana_odorifera
CUC_Sicana_odorifera__02	CUC_Sicana_odorifera
CUC_Sicana_odorifera__03	CUC_Sicana_odorifera
CUC_Sicana_odorifera__04	CUC_Sicana_odorifera
CUC_Sicana_odorifera__05	CUC_Sicana_odorifera
CUC_Sicydium_diffusum	CUC_Sicydium_diffusum
CUC_Sicydium_diffusum__00	CUC_Sicydium_diffusum
CUC_Sicydium_diffusum__01	CUC_Sicydium_diffusum
CUC_Sicydium_diffusum__02	CUC_Sicydium_diffusum
CUC_Sicyos_angulatus_GSK	CUC_Sicyos_angulatus_GSK
CUC_Sicyos_angulatus_GSK__00	CUC_Sicyos_angulatus_GSK
CUC_Sicyos_angulatus_GSK__01	CUC_Sicyos_angulatus_GSK
CUC_Sicyos_angulatus_GSK__02	CUC_Sicyos_angulatus_GSK
CUC_Sicyos_angulatus_GSK__03	CUC_Sicyos_angulatus_GSK
CUC_Sicyos_angulatus_GSK__04	CUC_Sicyos_angulatus_GSK
CUC_Sicyos_angulatus_GSK__05	CUC_Sicyos_angulatus_GSK
CUC_Sicyos_edulis_RNA	CUC_Sicyos_edulis_RNA
CUC_Sicyos_edulis_RNA__00	CUC_Sicyos_edulis_RNA
CUC_Sicyos_edulis_RNA__01	CUC_Sicyos_edulis_RNA
CUC_Sicyos_edulis_RNA__02	CUC_Sicyos_edulis_RNA
CUC_Sicyos_edulis_RNA__03	CUC_Sicyos_edulis_RNA
CUC_Sicyos_edulis_RNA__04	CUC_Sicyos_edulis_RNA
CUC_Sicyos_edulis_RNA__05	CUC_Sicyos_edulis_RNA
CUC_Sicyos_edulis_SB09_GSK	CUC_Sicyos_edulis_SB09_GSK
CUC_Sicyos_edulis_SB09_GSK__00	CUC_Sicyos_edulis_SB09_GSK
CUC_Sicyos_edulis_SB09_GSK__01	CUC_Sicyos_edulis_SB09_GSK
CUC_Sicyos_edulis_SB09_GSK__02	CUC_Sicyos_edulis_SB09_GSK
CUC_Siolmatra_brasiliensis	CUC_Siolmatra_brasiliensis
CUC_Siolmatra_brasiliensis__00	CUC_Siolmatra_brasiliensis
CUC_Siolmatra_brasiliensis__01	CUC_Siolmatra_brasiliensis
CUC_Siolmatra_brasiliensis__02	CUC_Siolmatra_brasiliensis
CUC_Siolmatra_brasiliensis__03	CUC_Siolmatra_brasiliensis
CUC_Siolmatra_brasiliensis__04	CUC_Siolmatra_brasiliensis
CUC_Siolmatra_brasiliensis__05	CUC_Siolmatra_brasiliensis
CUC_Siolmatra_pentaphylla_WGS	CUC_Siolmatra_pentaphylla_WGS
CUC_Siolmatra_pentaphylla_WGS__00	CUC_Siolmatra_pentaphylla_WGS
CUC_Siolmatra_pentaphylla_WGS__01	CUC_Siolmatra_pentaphylla_WGS
CUC_Siolmatra_pentaphylla_WGS__02	CUC_Siolmatra_pentaphylla_WGS
CUC_Siolmatra_pentaphylla_WGS__03	CUC_Siolmatra_pentaphylla_WGS
CUC_Siolmatra_pentaphylla_WGS__04	CUC_Siolmatra_pentaphylla_WGS
CUC_Siolmatra_pentaphylla_WGS__05	CUC_Siolmatra_pentaphylla_WGS
CUC_Siraitia_grosvenorii_1_RNA	CUC_Siraitia_grosvenorii_1_RNA
CUC_Siraitia_grosvenorii_1_RNA__00	CUC_Siraitia_grosvenorii_1_RNA
CUC_Siraitia_grosvenorii_1_RNA__01	CUC_Siraitia_grosvenorii_1_RNA
CUC_Siraitia_grosvenorii_1_RNA__02	CUC_Siraitia_grosvenorii_1_RNA
CUC_Siraitia_grosvenorii_2_RNA	CUC_Siraitia_grosvenorii_2_RNA
CUC_Siraitia_grosvenorii_2_RNA__00	CUC_Siraitia_grosvenorii_2_RNA
CUC_Siraitia_grosvenorii_2_RNA__01	CUC_Siraitia_grosvenorii_2_RNA
CUC_Siraitia_grosvenorii_2_RNA__02	CUC_Siraitia_grosvenorii_2_RNA
CUC_Siraitia_grosvenorii_2_RNA__03	CUC_Siraitia_grosvenorii_2_RNA
CUC_Siraitia_grosvenorii_2_RNA__04	CUC_Siraitia_grosvenorii_2_RNA
CUC_Siraitia_grosvenorii_2_RNA__05	CUC_Siraitia_grosvenorii_2_RNA
CUC_Siraitia_grosvenorii_3_RNA	CUC_Siraitia_grosvenorii_3_RNA
CUC_Siraitia_grosvenorii_3_RNA__00	CUC_Siraitia_grosvenorii_3_RNA
CUC_Siraitia_grosvenorii_3_RNA__01	CUC_Siraitia_grosvenorii_3_RNA
CUC_Siraitia_grosvenorii_3_RNA__02	CUC_Siraitia_grosvenorii_3_RNA
CUC_Siraitia_grosvenorii_3_RNA__03	CUC_Siraitia_grosvenorii_3_RNA
CUC_Siraitia_grosvenorii_3_RNA__04	CUC_Siraitia_grosvenorii_3_RNA
CUC_Siraitia_grosvenorii_3_RNA__05	CUC_Siraitia_grosvenorii_3_RNA
CUC_Siraitia_grosvenorii_WGS	CUC_Siraitia_grosvenorii_WGS
CUC_Siraitia_grosvenorii_WGS__00	CUC_Siraitia_grosvenorii_WGS
CUC_Siraitia_grosvenorii_WGS__01	CUC_Siraitia_grosvenorii_WGS
CUC_Siraitia_grosvenorii_WGS__02	CUC_Siraitia_grosvenorii_WGS
CUC_Siraitia_grosvenorii_WGS__03	CUC_Siraitia_grosvenorii_WGS
CUC_Siraitia_grosvenorii_WGS__04	CUC_Siraitia_grosvenorii_WGS
CUC_Siraitia_grosvenorii_WGS__05	CUC_Siraitia_grosvenorii_WGS
CUC_Solena_amplexicaulis_RNA	CUC_Solena_amplexicaulis_RNA
CUC_Solena_amplexicaulis_RNA__00	CUC_Solena_amplexicaulis_RNA
CUC_Solena_amplexicaulis_RNA__01	CUC_Solena_amplexicaulis_RNA
CUC_Solena_amplexicaulis_RNA__02	CUC_Solena_amplexicaulis_RNA
CUC_Solena_amplexicaulis_RNA__03	CUC_Solena_amplexicaulis_RNA
CUC_Solena_amplexicaulis_RNA__04	CUC_Solena_amplexicaulis_RNA
CUC_Solena_amplexicaulis_RNA__05	CUC_Solena_amplexicaulis_RNA
CUC_Solena_heterophylla	CUC_Solena_heterophylla
CUC_Solena_heterophylla__00	CUC_Solena_heterophylla
CUC_Solena_heterophylla__01	CUC_Solena_heterophylla
CUC_Solena_heterophylla__02	CUC_Solena_heterophylla
CUC_Solena_heterophylla__03	CUC_Solena_heterophylla
CUC_Solena_heterophylla__04	CUC_Solena_heterophylla
CUC_Solena_heterophylla__05	CUC_Solena_heterophylla
CUC_Tecunumania_stothertiae	CUC_Tecunumania_stothertiae
CUC_Tecunumania_stothertiae__00	CUC_Tecunumania_stothertiae
CUC_Tecunumania_stothertiae__01	CUC_Tecunumania_stothertiae
CUC_Tecunumania_stothertiae__02	CUC_Tecunumania_stothertiae
CUC_Telfairia_occidentalis_RNA	CUC_Telfairia_occidentalis_RNA
CUC_Telfairia_occidentalis_RNA__00	CUC_Telfairia_occidentalis_RNA
CUC_Telfairia_occidentalis_RNA__01	CUC_Telfairia_occidentalis_RNA
CUC_Telfairia_occidentalis_RNA__02	CUC_Telfairia_occidentalis_RNA
CUC_Telfairia_occidentalis_RNA__03	CUC_Telfairia_occidentalis_RNA
CUC_Telfairia_occidentalis_RNA__04	CUC_Telfairia_occidentalis_RNA
CUC_Telfairia_occidentalis_RNA__05	CUC_Telfairia_occidentalis_RNA
CUC_Telfairia_occidentalis_WGS	CUC_Telfairia_occidentalis_WGS
CUC_Telfairia_occidentalis_WGS__00	CUC_Telfairia_occidentalis_WGS
CUC_Telfairia_occidentalis_WGS__01	CUC_Telfairia_occidentalis_WGS
CUC_Telfairia_occidentalis_WGS__02	CUC_Telfairia_occidentalis_WGS
CUC_Telfairia_occidentalis_WGS__03	CUC_Telfairia_occidentalis_WGS
CUC_Telfairia_occidentalis_WGS__04	CUC_Telfairia_occidentalis_WGS
CUC_Telfairia_occidentalis_WGS__05	CUC_Telfairia_occidentalis_WGS
CUC_Telfairia_pedata	CUC_Telfairia_pedata
CUC_Telfairia_pedata_RNA	CUC_Telfairia_pedata_RNA
CUC_Telfairia_pedata_RNA__00	CUC_Telfairia_pedata_RNA
CUC_Telfairia_pedata_RNA__01	CUC_Telfairia_pedata_RNA
CUC_Telfairia_pedata_RNA__02	CUC_Telfairia_pedata_RNA
CUC_Telfairia_pedata_RNA__03	CUC_Telfairia_pedata_RNA
CUC_Telfairia_pedata_RNA__04	CUC_Telfairia_pedata_RNA
CUC_Telfairia_pedata_RNA__05	CUC_Telfairia_pedata_RNA
CUC_Telfairia_pedata__00	CUC_Telfairia_pedata
CUC_Telfairia_pedata__01	CUC_Telfairia_pedata
CUC_Telfairia_pedata__02	CUC_Telfairia_pedata
CUC_Telfairia_pedata__03	CUC_Telfairia_pedata
CUC_Telfairia_pedata__04	CUC_Telfairia_pedata
CUC_Thladiantha_cordifolia_RNA	CUC_Thladiantha_cordifolia_RNA
CUC_Thladiantha_cordifolia_RNA__00	CUC_Thladiantha_cordifolia_RNA
CUC_Thladiantha_cordifolia_RNA__01	CUC_Thladiantha_cordifolia_RNA
CUC_Thladiantha_cordifolia_RNA__02	CUC_Thladiantha_cordifolia_RNA
CUC_Thladiantha_cordifolia_RNA__03	CUC_Thladiantha_cordifolia_RNA
CUC_Thladiantha_cordifolia_RNA__04	CUC_Thladiantha_cordifolia_RNA
CUC_Thladiantha_cordifolia_RNA__05	CUC_Thladiantha_cordifolia_RNA
CUC_Thladiantha_dubia_SB06_GSK	CUC_Thladiantha_dubia_SB06_GSK
CUC_Thladiantha_dubia_SB06_GSK__00	CUC_Thladiantha_dubia_SB06_GSK
CUC_Thladiantha_dubia_SB06_GSK__01	CUC_Thladiantha_dubia_SB06_GSK
CUC_Thladiantha_dubia_SB06_GSK__02	CUC_Thladiantha_dubia_SB06_GSK
CUC_Thladiantha_dubia_SB06_GSK__03	CUC_Thladiantha_dubia_SB06_GSK
CUC_Thladiantha_globicarpa_RNA	CUC_Thladiantha_globicarpa_RNA
CUC_Thladiantha_globicarpa_RNA__00	CUC_Thladiantha_globicarpa_RNA
CUC_Thladiantha_globicarpa_RNA__01	CUC_Thladiantha_globicarpa_RNA
CUC_Thladiantha_globicarpa_RNA__02	CUC_Thladiantha_globicarpa_RNA
CUC_Thladiantha_globicarpa_RNA__03	CUC_Thladiantha_globicarpa_RNA
CUC_Thladiantha_globicarpa_RNA__04	CUC_Thladiantha_globicarpa_RNA
CUC_Thladiantha_globicarpa_RNA__05	CUC_Thladiantha_globicarpa_RNA
CUC_Thladiantha_hookeri	CUC_Thladiantha_hookeri
CUC_Thladiantha_hookeri__00	CUC_Thladiantha_hookeri
CUC_Thladiantha_hookeri__01	CUC_Thladiantha_hookeri
CUC_Thladiantha_hookeri__02	CUC_Thladiantha_hookeri
CUC_Thladiantha_hookeri__03	CUC_Thladiantha_hookeri
CUC_Thladiantha_hookeri__04	CUC_Thladiantha_hookeri
CUC_Thladiantha_nudiflora_RNA	CUC_Thladiantha_nudiflora_RNA
CUC_Thladiantha_nudiflora_RNA__00	CUC_Thladiantha_nudiflora_RNA
CUC_Thladiantha_nudiflora_RNA__01	CUC_Thladiantha_nudiflora_RNA
CUC_Thladiantha_nudiflora_RNA__02	CUC_Thladiantha_nudiflora_RNA
CUC_Thladiantha_nudiflora_RNA__03	CUC_Thladiantha_nudiflora_RNA
CUC_Thladiantha_nudiflora_RNA__04	CUC_Thladiantha_nudiflora_RNA
CUC_Thladiantha_punctata_RNA	CUC_Thladiantha_punctata_RNA
CUC_Thladiantha_punctata_RNA__00	CUC_Thladiantha_punctata_RNA
CUC_Thladiantha_punctata_RNA__01	CUC_Thladiantha_punctata_RNA
CUC_Thladiantha_punctata_RNA__02	CUC_Thladiantha_punctata_RNA
CUC_Thladiantha_punctata_RNA__03	CUC_Thladiantha_punctata_RNA
CUC_Thladiantha_punctata_RNA__04	CUC_Thladiantha_punctata_RNA
CUC_Thladiantha_punctata_RNA__05	CUC_Thladiantha_punctata_RNA
CUC_Thladiantha_villosula_RNA	CUC_Thladiantha_villosula_RNA
CUC_Thladiantha_villosula_RNA__00	CUC_Thladiantha_villosula_RNA
CUC_Thladiantha_villosula_RNA__01	CUC_Thladiantha_villosula_RNA
CUC_Trichosanthes_anguina_RNA	CUC_Trichosanthes_anguina_RNA
CUC_Trichosanthes_anguina_RNA__00	CUC_Trichosanthes_anguina_RNA
CUC_Trichosanthes_anguina_RNA__01	CUC_Trichosanthes_anguina_RNA
CUC_Trichosanthes_anguina_RNA__02	CUC_Trichosanthes_anguina_RNA
CUC_Trichosanthes_baviensis_RNA	CUC_Trichosanthes_baviensis_RNA
CUC_Trichosanthes_baviensis_RNA__00	CUC_Trichosanthes_baviensis_RNA
CUC_Trichosanthes_baviensis_RNA__01	CUC_Trichosanthes_baviensis_RNA
CUC_Trichosanthes_baviensis_RNA__02	CUC_Trichosanthes_baviensis_RNA
CUC_Trichosanthes_baviensis_RNA__03	CUC_Trichosanthes_baviensis_RNA
CUC_Trichosanthes_baviensis_RNA__04	CUC_Trichosanthes_baviensis_RNA
CUC_Trichosanthes_baviensis_RNA__05	CUC_Trichosanthes_baviensis_RNA
CUC_Trichosanthes_baviensis_SYS319_GSK	CUC_Trichosanthes_baviensis_SYS319_GSK
CUC_Trichosanthes_baviensis_SYS319_GSK__00	CUC_Trichosanthes_baviensis_SYS319_GSK
CUC_Trichosanthes_baviensis_SYS319_GSK__01	CUC_Trichosanthes_baviensis_SYS319_GSK
CUC_Trichosanthes_cucumerina	CUC_Trichosanthes_cucumerina
CUC_Trichosanthes_cucumerina__00	CUC_Trichosanthes_cucumerina
CUC_Trichosanthes_cucumerina__01	CUC_Trichosanthes_cucumerina
CUC_Trichosanthes_cucumerina__02	CUC_Trichosanthes_cucumerina
CUC_Trichosanthes_cucumerina__03	CUC_Trichosanthes_cucumerina
CUC_Trichosanthes_cucumerina__04	CUC_Trichosanthes_cucumerina
CUC_Trichosanthes_cucumerina__05	CUC_Trichosanthes_cucumerina
CUC_Trichosanthes_cucumeroides_RNA	CUC_Trichosanthes_cucumeroides_RNA
CUC_Trichosanthes_cucumeroides_RNA__00	CUC_Trichosanthes_cucumeroides_RNA
CUC_Trichosanthes_cucumeroides_RNA__01	CUC_Trichosanthes_cucumeroides_RNA
CUC_Trichosanthes_cucumeroides_RNA__02	CUC_Trichosanthes_cucumeroides_RNA
CUC_Trichosanthes_cucumeroides_RNA__03	CUC_Trichosanthes_cucumeroides_RNA
CUC_Trichosanthes_cucumeroides_RNA__04	CUC_Trichosanthes_cucumeroides_RNA
CUC_Trichosanthes_cucumeroides_RNA__05	CUC_Trichosanthes_cucumeroides_RNA
CUC_Trichosanthes_dunniana_RNA	CUC_Trichosanthes_dunniana_RNA
CUC_Trichosanthes_dunniana_RNA__00	CUC_Trichosanthes_dunniana_RNA
CUC_Trichosanthes_dunniana_RNA__01	CUC_Trichosanthes_dunniana_RNA
CUC_Trichosanthes_dunniana_RNA__02	CUC_Trichosanthes_dunniana_RNA
CUC_Trichosanthes_dunniana_RNA__03	CUC_Trichosanthes_dunniana_RNA
CUC_Trichosanthes_dunniana_RNA__04	CUC_Trichosanthes_dunniana_RNA
CUC_Trichosanthes_dunniana_RNA__05	CUC_Trichosanthes_dunniana_RNA
CUC_Trichosanthes_homophylla_SB10_GSK	CUC_Trichosanthes_homophylla_SB10_GSK
CUC_Trichosanthes_homophylla_SB10_GSK__00	CUC_Trichosanthes_homophylla_SB10_GSK
CUC_Trichosanthes_homophylla_SB10_GSK__01	CUC_Trichosanthes_homophylla_SB10_GSK
CUC_Trichosanthes_homophylla_SB10_GSK__02	CUC_Trichosanthes_homophylla_SB10_GSK
CUC_Trichosanthes_kirilowii_SB17_GSK	CUC_Trichosanthes_kirilowii_SB17_GSK
CUC_Trichosanthes_kirilowii_SB17_GSK__00	CUC_Trichosanthes_kirilowii_SB17_GSK
CUC_Trichosanthes_kirilowii_SB17_GSK__01	CUC_Trichosanthes_kirilowii_SB17_GSK
CUC_Trichosanthes_kirilowii_SB17_GSK__02	CUC_Trichosanthes_kirilowii_SB17_GSK
CUC_Trichosanthes_kirilowii_SB17_GSK__03	CUC_Trichosanthes_kirilowii_SB17_GSK
CUC_Trichosanthes_lepiniana_RNA	CUC_Trichosanthes_lepiniana_RNA
CUC_Trichosanthes_lepiniana_RNA__00	CUC_Trichosanthes_lepiniana_RNA
CUC_Trichosanthes_lepiniana_RNA__01	CUC_Trichosanthes_lepiniana_RNA
CUC_Trichosanthes_lepiniana_RNA__02	CUC_Trichosanthes_lepiniana_RNA
CUC_Trichosanthes_lepiniana_RNA__03	CUC_Trichosanthes_lepiniana_RNA
CUC_Trichosanthes_lepiniana_RNA__04	CUC_Trichosanthes_lepiniana_RNA
CUC_Trichosanthes_lepiniana_RNA__05	CUC_Trichosanthes_lepiniana_RNA
CUC_Trichosanthes_lobata_SYS456_GSK	CUC_Trichosanthes_lobata_SYS456_GSK
CUC_Trichosanthes_lobata_SYS456_GSK__00	CUC_Trichosanthes_lobata_SYS456_GSK
CUC_Trichosanthes_lobata_SYS456_GSK__01	CUC_Trichosanthes_lobata_SYS456_GSK
CUC_Trichosanthes_lobata_SYS456_GSK__02	CUC_Trichosanthes_lobata_SYS456_GSK
CUC_Trichosanthes_lobata_SYS456_GSK__03	CUC_Trichosanthes_lobata_SYS456_GSK
CUC_Trichosanthes_lobata_SYS456_GSK__04	CUC_Trichosanthes_lobata_SYS456_GSK
CUC_Trichosanthes_nervifolia_SB18_GSK	CUC_Trichosanthes_nervifolia_SB18_GSK
CUC_Trichosanthes_nervifolia_SB18_GSK__00	CUC_Trichosanthes_nervifolia_SB18_GSK
CUC_Trichosanthes_nervifolia_SB18_GSK__01	CUC_Trichosanthes_nervifolia_SB18_GSK
CUC_Trichosanthes_nervifolia_SB18_GSK__02	CUC_Trichosanthes_nervifolia_SB18_GSK
CUC_Trichosanthes_pedata_RNA	CUC_Trichosanthes_pedata_RNA
CUC_Trichosanthes_pedata_RNA__00	CUC_Trichosanthes_pedata_RNA
CUC_Trichosanthes_pedata_RNA__01	CUC_Trichosanthes_pedata_RNA
CUC_Trichosanthes_pedata_RNA__02	CUC_Trichosanthes_pedata_RNA
CUC_Trichosanthes_pedata_RNA__03	CUC_Trichosanthes_pedata_RNA
CUC_Trichosanthes_pedata_RNA__04	CUC_Trichosanthes_pedata_RNA
CUC_Trichosanthes_pedata_RNA__05	CUC_Trichosanthes_pedata_RNA
CUC_Trichosanthes_pilosa	CUC_Trichosanthes_pilosa
CUC_Trichosanthes_pilosa_1_RNA	CUC_Trichosanthes_pilosa_1_RNA
CUC_Trichosanthes_pilosa_1_RNA__00	CUC_Trichosanthes_pilosa_1_RNA
CUC_Trichosanthes_pilosa_1_RNA__01	CUC_Trichosanthes_pilosa_1_RNA
CUC_Trichosanthes_pilosa_1_RNA__02	CUC_Trichosanthes_pilosa_1_RNA
CUC_Trichosanthes_pilosa_1_RNA__03	CUC_Trichosanthes_pilosa_1_RNA
CUC_Trichosanthes_pilosa_1_RNA__04	CUC_Trichosanthes_pilosa_1_RNA
CUC_Trichosanthes_pilosa_1_RNA__05	CUC_Trichosanthes_pilosa_1_RNA
CUC_Trichosanthes_pilosa_2_RNA	CUC_Trichosanthes_pilosa_2_RNA
CUC_Trichosanthes_pilosa_2_RNA__00	CUC_Trichosanthes_pilosa_2_RNA
CUC_Trichosanthes_pilosa_2_RNA__01	CUC_Trichosanthes_pilosa_2_RNA
CUC_Trichosanthes_pilosa_2_RNA__02	CUC_Trichosanthes_pilosa_2_RNA
CUC_Trichosanthes_pilosa_SYS242_GSK	CUC_Trichosanthes_pilosa_SYS242_GSK
CUC_Trichosanthes_pilosa_SYS242_GSK__00	CUC_Trichosanthes_pilosa_SYS242_GSK
CUC_Trichosanthes_pilosa_SYS242_GSK__01	CUC_Trichosanthes_pilosa_SYS242_GSK
CUC_Trichosanthes_pilosa__00	CUC_Trichosanthes_pilosa
CUC_Trichosanthes_pilosa__01	CUC_Trichosanthes_pilosa
CUC_Trichosanthes_pilosa__02	CUC_Trichosanthes_pilosa
CUC_Trichosanthes_pubera_RNA	CUC_Trichosanthes_pubera_RNA
CUC_Trichosanthes_pubera_RNA__00	CUC_Trichosanthes_pubera_RNA
CUC_Trichosanthes_pubera_RNA__01	CUC_Trichosanthes_pubera_RNA
CUC_Trichosanthes_pubera_RNA__02	CUC_Trichosanthes_pubera_RNA
CUC_Trichosanthes_pubera_RNA__03	CUC_Trichosanthes_pubera_RNA
CUC_Trichosanthes_pubera_RNA__04	CUC_Trichosanthes_pubera_RNA
CUC_Trichosanthes_pubera_RNA__05	CUC_Trichosanthes_pubera_RNA
CUC_Trichosanthes_rosthornii_1_RNA	CUC_Trichosanthes_rosthornii_1_RNA
CUC_Trichosanthes_rosthornii_1_RNA__00	CUC_Trichosanthes_rosthornii_1_RNA
CUC_Trichosanthes_rosthornii_1_RNA__01	CUC_Trichosanthes_rosthornii_1_RNA
CUC_Trichosanthes_rosthornii_1_RNA__02	CUC_Trichosanthes_rosthornii_1_RNA
CUC_Trichosanthes_rosthornii_1_RNA__03	CUC_Trichosanthes_rosthornii_1_RNA
CUC_Trichosanthes_rosthornii_1_RNA__04	CUC_Trichosanthes_rosthornii_1_RNA
CUC_Trichosanthes_rosthornii_1_RNA__05	CUC_Trichosanthes_rosthornii_1_RNA
CUC_Trichosanthes_rosthornii_2_RNA	CUC_Trichosanthes_rosthornii_2_RNA
CUC_Trichosanthes_rosthornii_2_RNA__00	CUC_Trichosanthes_rosthornii_2_RNA
CUC_Trichosanthes_rosthornii_2_RNA__01	CUC_Trichosanthes_rosthornii_2_RNA
CUC_Trichosanthes_rosthornii_2_RNA__02	CUC_Trichosanthes_rosthornii_2_RNA
CUC_Trichosanthes_rosthornii_2_RNA__03	CUC_Trichosanthes_rosthornii_2_RNA
CUC_Trichosanthes_rosthornii_2_RNA__04	CUC_Trichosanthes_rosthornii_2_RNA
CUC_Trichosanthes_rosthornii_2_RNA__05	CUC_Trichosanthes_rosthornii_2_RNA
CUC_Trichosanthes_rubriflos_GJ110_RNA	CUC_Trichosanthes_rubriflos_GJ110_RNA
CUC_Trichosanthes_rubriflos_GJ110_RNA__00	CUC_Trichosanthes_rubriflos_GJ110_RNA
CUC_Trichosanthes_rubriflos_GJ110_RNA__01	CUC_Trichosanthes_rubriflos_GJ110_RNA
CUC_Trichosanthes_rubriflos_GJ110_RNA__02	CUC_Trichosanthes_rubriflos_GJ110_RNA
CUC_Trichosanthes_rubriflos_GJ110_RNA__03	CUC_Trichosanthes_rubriflos_GJ110_RNA
CUC_Trichosanthes_rubriflos_GJ110_RNA__04	CUC_Trichosanthes_rubriflos_GJ110_RNA
CUC_Trichosanthes_rubriflos_GJ110_RNA__05	CUC_Trichosanthes_rubriflos_GJ110_RNA
CUC_Trichosanthes_scabra_RNA	CUC_Trichosanthes_scabra_RNA
CUC_Trichosanthes_scabra_RNA__00	CUC_Trichosanthes_scabra_RNA
CUC_Trichosanthes_scabra_RNA__01	CUC_Trichosanthes_scabra_RNA
CUC_Trichosanthes_scabra_RNA__02	CUC_Trichosanthes_scabra_RNA
CUC_Trichosanthes_sericeifolia_RNA	CUC_Trichosanthes_sericeifolia_RNA
CUC_Trichosanthes_sericeifolia_RNA__00	CUC_Trichosanthes_sericeifolia_RNA
CUC_Trichosanthes_sericeifolia_RNA__01	CUC_Trichosanthes_sericeifolia_RNA
CUC_Trichosanthes_sericeifolia_RNA__02	CUC_Trichosanthes_sericeifolia_RNA
CUC_Trichosanthes_sp_XWB13719_RNA	CUC_Trichosanthes_sp_XWB13719_RNA
CUC_Trichosanthes_sp_XWB13719_RNA__00	CUC_Trichosanthes_sp_XWB13719_RNA
CUC_Trichosanthes_sp_XWB13719_RNA__01	CUC_Trichosanthes_sp_XWB13719_RNA
CUC_Trichosanthes_sp_XWB13719_RNA__02	CUC_Trichosanthes_sp_XWB13719_RNA
CUC_Trichosanthes_sp_XWB13719_RNA__03	CUC_Trichosanthes_sp_XWB13719_RNA
CUC_Trichosanthes_sp_XWB13719_RNA__04	CUC_Trichosanthes_sp_XWB13719_RNA
CUC_Trichosanthes_tricuspidata_SYS145_GSK	CUC_Trichosanthes_tricuspidata_SYS145_GSK
CUC_Trichosanthes_tricuspidata_SYS145_GSK__00	CUC_Trichosanthes_tricuspidata_SYS145_GSK
CUC_Trichosanthes_tricuspidata_SYS145_GSK__01	CUC_Trichosanthes_tricuspidata_SYS145_GSK
CUC_Trichosanthes_tricuspidata_SYS145_GSK__02	CUC_Trichosanthes_tricuspidata_SYS145_GSK
CUC_Trichosanthes_tricuspidata_SYS145_GSK__03	CUC_Trichosanthes_tricuspidata_SYS145_GSK
CUC_Trichosanthes_tricuspidata_SYS145_GSK__04	CUC_Trichosanthes_tricuspidata_SYS145_GSK
CUC_Trichosanthes_truncata_RNA	CUC_Trichosanthes_truncata_RNA
CUC_Trichosanthes_truncata_RNA__00	CUC_Trichosanthes_truncata_RNA
CUC_Trichosanthes_truncata_RNA__01	CUC_Trichosanthes_truncata_RNA
CUC_Trichosanthes_truncata_RNA__02	CUC_Trichosanthes_truncata_RNA
CUC_Trichosanthes_truncata_RNA__03	CUC_Trichosanthes_truncata_RNA
CUC_Trichosanthes_truncata_RNA__04	CUC_Trichosanthes_truncata_RNA
CUC_Trichosanthes_truncata_RNA__05	CUC_Trichosanthes_truncata_RNA
CUC_Trichosanthes_truncata_SYS368_GSK	CUC_Trichosanthes_truncata_SYS368_GSK
CUC_Trichosanthes_truncata_SYS368_GSK__00	CUC_Trichosanthes_truncata_SYS368_GSK
CUC_Trichosanthes_truncata_SYS368_GSK__01	CUC_Trichosanthes_truncata_SYS368_GSK
CUC_Trichosanthes_truncata_SYS368_GSK__02	CUC_Trichosanthes_truncata_SYS368_GSK
CUC_Trichosanthes_truncata_SYS368_GSK__03	CUC_Trichosanthes_truncata_SYS368_GSK
CUC_Trichosanthes_truncata_SYS368_GSK__04	CUC_Trichosanthes_truncata_SYS368_GSK
CUC_Trichosanthes_tubiflora_SYS506_GSK	CUC_Trichosanthes_tubiflora_SYS506_GSK
CUC_Trichosanthes_tubiflora_SYS506_GSK__00	CUC_Trichosanthes_tubiflora_SYS506_GSK
CUC_Trichosanthes_tubiflora_SYS506_GSK__01	CUC_Trichosanthes_tubiflora_SYS506_GSK
CUC_Trichosanthes_villosa_RNA	CUC_Trichosanthes_villosa_RNA
CUC_Trichosanthes_villosa_RNA__00	CUC_Trichosanthes_villosa_RNA
CUC_Trichosanthes_villosa_RNA__01	CUC_Trichosanthes_villosa_RNA
CUC_Trichosanthes_villosa_RNA__02	CUC_Trichosanthes_villosa_RNA
CUC_Trichosanthes_wallichiana_SB14_GSK	CUC_Trichosanthes_wallichiana_SB14_GSK
CUC_Trichosanthes_wallichiana_SB14_GSK__00	CUC_Trichosanthes_wallichiana_SB14_GSK
CUC_Trichosanthes_wallichiana_SB14_GSK__01	CUC_Trichosanthes_wallichiana_SB14_GSK
CUC_Trichosanthes_wallichiana_SB14_GSK__02	CUC_Trichosanthes_wallichiana_SB14_GSK
CUC_Trochomeria_macrocarpa	CUC_Trochomeria_macrocarpa
CUC_Trochomeria_macrocarpa_RNA	CUC_Trochomeria_macrocarpa_RNA
CUC_Trochomeria_macrocarpa_RNA__00	CUC_Trochomeria_macrocarpa_RNA
CUC_Trochomeria_macrocarpa_RNA__01	CUC_Trochomeria_macrocarpa_RNA
CUC_Trochomeria_macrocarpa_RNA__02	CUC_Trochomeria_macrocarpa_RNA
CUC_Trochomeria_macrocarpa_RNA__03	CUC_Trochomeria_macrocarpa_RNA
CUC_Trochomeria_macrocarpa_RNA__04	CUC_Trochomeria_macrocarpa_RNA
CUC_Trochomeria_macrocarpa_RNA__05	CUC_Trochomeria_macrocarpa_RNA
CUC_Trochomeria_macrocarpa__00	CUC_Trochomeria_macrocarpa
CUC_Trochomeria_macrocarpa__01	CUC_Trochomeria_macrocarpa
CUC_Trochomeria_macrocarpa__02	CUC_Trochomeria_macrocarpa
CUC_Trochomeria_macrocarpa__03	CUC_Trochomeria_macrocarpa
CUC_Trochomeria_macrocarpa__04	CUC_Trochomeria_macrocarpa
CUC_Trochomeria_macrocarpa__05	CUC_Trochomeria_macrocarpa
CUC_Trochomeriopsis_diversifolia	CUC_Trochomeriopsis_diversifolia
CUC_Trochomeriopsis_diversifolia_RNA	CUC_Trochomeriopsis_diversifolia_RNA
CUC_Trochomeriopsis_diversifolia_RNA__00	CUC_Trochomeriopsis_diversifolia_RNA
CUC_Trochomeriopsis_diversifolia_RNA__01	CUC_Trochomeriopsis_diversifolia_RNA
CUC_Trochomeriopsis_diversifolia_RNA__02	CUC_Trochomeriopsis_diversifolia_RNA
CUC_Trochomeriopsis_diversifolia_RNA__03	CUC_Trochomeriopsis_diversifolia_RNA
CUC_Trochomeriopsis_diversifolia_RNA__04	CUC_Trochomeriopsis_diversifolia_RNA
CUC_Trochomeriopsis_diversifolia_RNA__05	CUC_Trochomeriopsis_diversifolia_RNA
CUC_Trochomeriopsis_diversifolia__00	CUC_Trochomeriopsis_diversifolia
CUC_Trochomeriopsis_diversifolia__01	CUC_Trochomeriopsis_diversifolia
CUC_Trochomeriopsis_diversifolia__02	CUC_Trochomeriopsis_diversifolia
CUC_Trochomeriopsis_diversifolia__03	CUC_Trochomeriopsis_diversifolia
CUC_Trochomeriopsis_diversifolia__04	CUC_Trochomeriopsis_diversifolia
CUC_Trochomeriopsis_diversifolia__05	CUC_Trochomeriopsis_diversifolia
CUC_Tumamoca_macdougalii	CUC_Tumamoca_macdougalii
CUC_Tumamoca_macdougalii__00	CUC_Tumamoca_macdougalii
CUC_Tumamoca_macdougalii__01	CUC_Tumamoca_macdougalii
CUC_Tumamoca_macdougalii__02	CUC_Tumamoca_macdougalii
CUC_Tumamoca_macdougalii__03	CUC_Tumamoca_macdougalii
CUC_Tumamoca_macdougalii__04	CUC_Tumamoca_macdougalii
CUC_Tumamoca_macdougalii__05	CUC_Tumamoca_macdougalii
CUC_Wilbrandia_ebracteata	CUC_Wilbrandia_ebracteata
CUC_Wilbrandia_ebracteata__00	CUC_Wilbrandia_ebracteata
CUC_Wilbrandia_ebracteata__01	CUC_Wilbrandia_ebracteata
CUC_Wilbrandia_ebracteata__02	CUC_Wilbrandia_ebracteata
CUC_Wilbrandia_ebracteata__03	CUC_Wilbrandia_ebracteata
CUC_Wilbrandia_hibiscoides_WGS	CUC_Wilbrandia_hibiscoides_WGS
CUC_Wilbrandia_hibiscoides_WGS__00	CUC_Wilbrandia_hibiscoides_WGS
CUC_Wilbrandia_hibiscoides_WGS__01	CUC_Wilbrandia_hibiscoides_WGS
CUC_Wilbrandia_hibiscoides_WGS__02	CUC_Wilbrandia_hibiscoides_WGS
CUC_Wilbrandia_hibiscoides_WGS__03	CUC_Wilbrandia_hibiscoides_WGS
CUC_Wilbrandia_hibiscoides_WGS__04	CUC_Wilbrandia_hibiscoides_WGS
CUC_Wilbrandia_hibiscoides_WGS__05	CUC_Wilbrandia_hibiscoides_WGS
CUC_Wilbrandia_verticillata_WGS	CUC_Wilbrandia_verticillata_WGS
CUC_Wilbrandia_verticillata_WGS__00	CUC_Wilbrandia_verticillata_WGS
CUC_Wilbrandia_verticillata_WGS__01	CUC_Wilbrandia_verticillata_WGS
CUC_Wilbrandia_verticillata_WGS__02	CUC_Wilbrandia_verticillata_WGS
CUC_Wilbrandia_verticillata_WGS__03	CUC_Wilbrandia_verticillata_WGS
CUC_Wilbrandia_verticillata_WGS__04	CUC_Wilbrandia_verticillata_WGS
CUC_Wilbrandia_verticillata_WGS__05	CUC_Wilbrandia_verticillata_WGS
CUC_Xerosicyos_danguyi_RNA	CUC_Xerosicyos_danguyi_RNA
CUC_Xerosicyos_danguyi_RNA__00	CUC_Xerosicyos_danguyi_RNA
CUC_Xerosicyos_danguyi_RNA__01	CUC_Xerosicyos_danguyi_RNA
CUC_Xerosicyos_danguyi_RNA__02	CUC_Xerosicyos_danguyi_RNA
CUC_Xerosicyos_danguyi_RNA__03	CUC_Xerosicyos_danguyi_RNA
CUC_Xerosicyos_danguyi_RNA__04	CUC_Xerosicyos_danguyi_RNA
CUC_Xerosicyos_danguyi_RNA__05	CUC_Xerosicyos_danguyi_RNA
CUC_Xerosicyos_perrieri_RNA	CUC_Xerosicyos_perrieri_RNA
CUC_Xerosicyos_perrieri_RNA__00	CUC_Xerosicyos_perrieri_RNA
CUC_Xerosicyos_perrieri_RNA__01	CUC_Xerosicyos_perrieri_RNA
CUC_Xerosicyos_perrieri_RNA__02	CUC_Xerosicyos_perrieri_RNA
CUC_Xerosicyos_perrieri_RNA__03	CUC_Xerosicyos_perrieri_RNA
CUC_Xerosicyos_perrieri_RNA__04	CUC_Xerosicyos_perrieri_RNA
CUC_Xerosicyos_pubescens	CUC_Xerosicyos_pubescens
CUC_Xerosicyos_pubescens_RNA	CUC_Xerosicyos_pubescens_RNA
CUC_Xerosicyos_pubescens_RNA__00	CUC_Xerosicyos_pubescens_RNA
CUC_Xerosicyos_pubescens_RNA__01	CUC_Xerosicyos_pubescens_RNA
CUC_Xerosicyos_pubescens_RNA__02	CUC_Xerosicyos_pubescens_RNA
CUC_Xerosicyos_pubescens_RNA__03	CUC_Xerosicyos_pubescens_RNA
CUC_Xerosicyos_pubescens_RNA__04	CUC_Xerosicyos_pubescens_RNA
CUC_Xerosicyos_pubescens_RNA__05	CUC_Xerosicyos_pubescens_RNA
CUC_Xerosicyos_pubescens__00	CUC_Xerosicyos_pubescens
CUC_Xerosicyos_pubescens__01	CUC_Xerosicyos_pubescens
CUC_Xerosicyos_pubescens__02	CUC_Xerosicyos_pubescens
CUC_Xerosicyos_pubescens__03	CUC_Xerosicyos_pubescens
CUC_Xerosicyos_pubescens__04	CUC_Xerosicyos_pubescens
CUC_Xerosicyos_pubescens__05	CUC_Xerosicyos_pubescens
CUC_Xerosicyos_tripartitus_RNA	CUC_Xerosicyos_tripartitus_RNA
CUC_Xerosicyos_tripartitus_RNA__00	CUC_Xerosicyos_tripartitus_RNA
CUC_Xerosicyos_tripartitus_RNA__01	CUC_Xerosicyos_tripartitus_RNA
CUC_Xerosicyos_tripartitus_RNA__02	CUC_Xerosicyos_tripartitus_RNA
CUC_Xerosicyos_tripartitus_RNA__03	CUC_Xerosicyos_tripartitus_RNA
CUC_Zanonia_indica	CUC_Zanonia_indica
CUC_Zanonia_indica__00	CUC_Zanonia_indica
CUC_Zanonia_indica__01	CUC_Zanonia_indica
CUC_Zanonia_indica__02	CUC_Zanonia_indica
CUC_Zehneria_indica_RNA	CUC_Zehneria_indica_RNA
CUC_Zehneria_indica_RNA__00	CUC_Zehneria_indica_RNA
CUC_Zehneria_indica_RNA__01	CUC_Zehneria_indica_RNA
CUC_Zehneria_indica_RNA__02	CUC_Zehneria_indica_RNA
CUC_Zehneria_indica_RNA__03	CUC_Zehneria_indica_RNA
CUC_Zehneria_indica_RNA__04	CUC_Zehneria_indica_RNA
CUC_Zehneria_maysorensis_RNA	CUC_Zehneria_maysorensis_RNA
CUC_Zehneria_maysorensis_RNA__00	CUC_Zehneria_maysorensis_RNA
CUC_Zehneria_maysorensis_RNA__01	CUC_Zehneria_maysorensis_RNA
CUC_Zehneria_maysorensis_RNA__02	CUC_Zehneria_maysorensis_RNA
CUC_Zehneria_maysorensis_RNA__03	CUC_Zehneria_maysorensis_RNA
CUC_Zehneria_maysorensis_RNA__04	CUC_Zehneria_maysorensis_RNA
CUC_Zehneria_maysorensis_RNA__05	CUC_Zehneria_maysorensis_RNA
CUC_Zehneria_mucronata_RNA	CUC_Zehneria_mucronata_RNA
CUC_Zehneria_mucronata_RNA__00	CUC_Zehneria_mucronata_RNA
CUC_Zehneria_mucronata_RNA__01	CUC_Zehneria_mucronata_RNA
CUC_Zehneria_mucronata_RNA__02	CUC_Zehneria_mucronata_RNA
CUC_Zehneria_mucronata_RNA__03	CUC_Zehneria_mucronata_RNA
CUC_Zehneria_mucronata_RNA__04	CUC_Zehneria_mucronata_RNA
CUC_Zehneria_mucronata_RNA__05	CUC_Zehneria_mucronata_RNA
CUC_Zehneria_pallidinervia_RNA	CUC_Zehneria_pallidinervia_RNA
CUC_Zehneria_pallidinervia_RNA__00	CUC_Zehneria_pallidinervia_RNA
CUC_Zehneria_pallidinervia_RNA__01	CUC_Zehneria_pallidinervia_RNA
CUC_Zehneria_pallidinervia_RNA__02	CUC_Zehneria_pallidinervia_RNA
CUC_Zehneria_pallidinervia_RNA__03	CUC_Zehneria_pallidinervia_RNA
CUC_Zehneria_scabra	CUC_Zehneria_scabra
CUC_Zehneria_scabra_RNA	CUC_Zehneria_scabra_RNA
CUC_Zehneria_scabra_RNA__00	CUC_Zehneria_scabra_RNA
CUC_Zehneria_scabra_RNA__01	CUC_Zehneria_scabra_RNA
CUC_Zehneria_scabra_RNA__02	CUC_Zehneria_scabra_RNA
CUC_Zehneria_scabra_RNA__03	CUC_Zehneria_scabra_RNA
CUC_Zehneria_scabra_RNA__04	CUC_Zehneria_scabra_RNA
CUC_Zehneria_scabra_RNA__05	CUC_Zehneria_scabra_RNA
CUC_Zehneria_scabra__00	CUC_Zehneria_scabra
CUC_Zehneria_scabra__01	CUC_Zehneria_scabra
CUC_Zehneria_scabra__02	CUC_Zehneria_scabra
CUC_Zehneria_scabra__03	CUC_Zehneria_scabra
CUC_Zehneria_scabra__04	CUC_Zehneria_scabra
CUC_Zehneria_scabra__05	CUC_Zehneria_scabra
CUC_Zehneria_sp	CUC_Zehneria_sp
CUC_Zehneria_sp__00	CUC_Zehneria_sp
CUC_Zehneria_sp__01	CUC_Zehneria_sp
CUC_Zehneria_sp__02	CUC_Zehneria_sp
CVDF__ref	CVDF__ref
CWYJ__ref	CWYJ__ref
CWZU__ref	CWZU__ref
CZPV__ref	CZPV__ref
Carpa-ASGPBv0.4__ref	Carpa-ASGPBv0.4__ref
DAAD__ref	DAAD__ref
DAT_Datisca_cannabina	DAT_Datisca_cannabina
DAT_Datisca_cannabina__00	DAT_Datisca_cannabina
DAT_Datisca_cannabina__01	DAT_Datisca_cannabina
DAT_Datisca_cannabina__02	DAT_Datisca_cannabina
DAT_Datisca_cannabina__03	DAT_Datisca_cannabina
DAT_Datisca_cannabina__04	DAT_Datisca_cannabina
DAT_Datisca_cannabina__05	DAT_Datisca_cannabina
DAT_Datisca_glomerata_WGS	DAT_Datisca_glomerata_WGS
DAT_Datisca_glomerata_WGS__00	DAT_Datisca_glomerata_WGS
DAT_Datisca_glomerata_WGS__01	DAT_Datisca_glomerata_WGS
DAT_Datisca_glomerata_WGS__02	DAT_Datisca_glomerata_WGS
DAT_Datisca_glomerata_WGS__03	DAT_Datisca_glomerata_WGS
DAT_Datisca_glomerata_WGS__04	DAT_Datisca_glomerata_WGS
DAT_Datisca_glomerata_WGS__05	DAT_Datisca_glomerata_WGS
DAT_Datisca_glomerata_leaf_RNA	DAT_Datisca_glomerata_leaf_RNA
DAT_Datisca_glomerata_leaf_RNA__00	DAT_Datisca_glomerata_leaf_RNA
DAT_Datisca_glomerata_leaf_RNA__01	DAT_Datisca_glomerata_leaf_RNA
DAT_Datisca_glomerata_leaf_RNA__02	DAT_Datisca_glomerata_leaf_RNA
DAT_Datisca_glomerata_leaf_RNA__03	DAT_Datisca_glomerata_leaf_RNA
DAT_Datisca_glomerata_nodule_RNA	DAT_Datisca_glomerata_nodule_RNA
DAT_Datisca_glomerata_nodule_RNA__00	DAT_Datisca_glomerata_nodule_RNA
DAT_Datisca_glomerata_nodule_RNA__01	DAT_Datisca_glomerata_nodule_RNA
DAT_Datisca_glomerata_nodule_RNA__02	DAT_Datisca_glomerata_nodule_RNA
DAT_Datisca_glomerata_nodule_RNA__03	DAT_Datisca_glomerata_nodule_RNA
DAT_Datisca_glomerata_root_RNA	DAT_Datisca_glomerata_root_RNA
DAT_Datisca_glomerata_root_RNA__00	DAT_Datisca_glomerata_root_RNA
DAT_Datisca_glomerata_root_RNA__01	DAT_Datisca_glomerata_root_RNA
DAT_Datisca_glomerata_root_RNA__02	DAT_Datisca_glomerata_root_RNA
DAT_Datisca_glomerata_root_RNA__03	DAT_Datisca_glomerata_root_RNA
DAT_Datisca_glomerata_root_RNA__04	DAT_Datisca_glomerata_root_RNA
DAT_Datisca_glomerata_root_RNA__05	DAT_Datisca_glomerata_root_RNA
DAYQ__ref	DAYQ__ref
DDRL__ref	DDRL__ref
DESP__ref	DESP__ref
DFYF__ref	DFYF__ref
DGXS__ref	DGXS__ref
DHPO__ref	DHPO__ref
DIHD__ref	DIHD__ref
DLAI__ref	DLAI__ref
DLJZ__ref	DLJZ__ref
DMLT__ref	DMLT__ref
DOVJ__ref	DOVJ__ref
DPFW__ref	DPFW__ref
DRIL__ref	DRIL__ref
DTNC__ref	DTNC__ref
DUNJ__ref	DUNJ__ref
DUQG__ref	DUQG__ref
DVXD__ref	DVXD__ref
DXQW__ref	DXQW__ref
DZLN__ref	DZLN__ref
DZTK__ref	DZTK__ref
ECTD__ref	ECTD__ref
EDBB__ref	EDBB__ref
EDEQ__ref	EDEQ__ref
EDHN__ref	EDHN__ref
EDIT__ref	EDIT__ref
EDXZ__ref	EDXZ__ref
EFCZ__ref	EFCZ__ref
EGOS__ref	EGOS__ref
EHNF__ref	EHNF__ref
EILE__ref	EILE__ref
EJCM__ref	EJCM__ref
EMAL__ref	EMAL__ref
EMBR__ref	EMBR__ref
EMJJ__ref	EMJJ__ref
EQDA__ref	EQDA__ref
ERIA__ref	ERIA__ref
ERWT__ref	ERWT__ref
EVOD__ref	EVOD__ref
EYKJ__ref	EYKJ__ref
EYRD__ref	EYRD__ref
EZGR__ref	EZGR__ref
EZZT__ref	EZZT__ref
Eucgr-v1.1__ref	Eucgr-v1.1__ref
FAG_Betula_pendula_RNA	FAG_Betula_pendula_RNA
FAG_Betula_pendula_RNA__00	FAG_Betula_pendula_RNA
FAG_Betula_pendula_RNA__01	FAG_Betula_pendula_RNA
FAG_Carya_glabra_RNA	FAG_Carya_glabra_RNA
FAG_Carya_glabra_RNA__00	FAG_Carya_glabra_RNA
FAG_Carya_glabra_RNA__01	FAG_Carya_glabra_RNA
FAG_Castanea_crenata_RNA	FAG_Castanea_crenata_RNA
FAG_Castanea_crenata_RNA__00	FAG_Castanea_crenata_RNA
FAG_Castanea_crenata_RNA__01	FAG_Castanea_crenata_RNA
FAG_Castanea_crenata_RNA__02	FAG_Castanea_crenata_RNA
FAG_Castanea_crenata_RNA__03	FAG_Castanea_crenata_RNA
FAG_Castanea_pumila_RNA	FAG_Castanea_pumila_RNA
FAG_Castanea_pumila_RNA__00	FAG_Castanea_pumila_RNA
FAG_Castanea_pumila_RNA__01	FAG_Castanea_pumila_RNA
FAG_Castanea_pumila_RNA__02	FAG_Castanea_pumila_RNA
FAG_Casuarina_equisetifolia_RNA	FAG_Casuarina_equisetifolia_RNA
FAG_Casuarina_equisetifolia_RNA__00	FAG_Casuarina_equisetifolia_RNA
FAG_Casuarina_equisetifolia_RNA__01	FAG_Casuarina_equisetifolia_RNA
FAG_Casuarina_equisetifolia_RNA__02	FAG_Casuarina_equisetifolia_RNA
FAG_Casuarina_equisetifolia_RNA__03	FAG_Casuarina_equisetifolia_RNA
FAG_Casuarina_equisetifolia_RNA__04	FAG_Casuarina_equisetifolia_RNA
FAG_Fagus_sylvatica_RNA	FAG_Fagus_sylvatica_RNA
FAG_Fagus_sylvatica_RNA__00	FAG_Fagus_sylvatica_RNA
FAG_Fagus_sylvatica_RNA__01	FAG_Fagus_sylvatica_RNA
FAG_Fagus_sylvatica_RNA__02	FAG_Fagus_sylvatica_RNA
FAG_Fagus_sylvatica_RNA__03	FAG_Fagus_sylvatica_RNA
FAG_Juglans_nigra_RNA	FAG_Juglans_nigra_RNA
FAG_Juglans_nigra_RNA__00	FAG_Juglans_nigra_RNA
FAG_Juglans_nigra_RNA__01	FAG_Juglans_nigra_RNA
FAG_Juglans_nigra_RNA__02	FAG_Juglans_nigra_RNA
FAG_Lophozonia_obliqua_RNA	FAG_Lophozonia_obliqua_RNA
FAG_Lophozonia_obliqua_RNA__00	FAG_Lophozonia_obliqua_RNA
FAG_Lophozonia_obliqua_RNA__01	FAG_Lophozonia_obliqua_RNA
FAG_Lophozonia_obliqua_RNA__02	FAG_Lophozonia_obliqua_RNA
FAG_Morella_cerifera_RNA	FAG_Morella_cerifera_RNA
FAG_Morella_cerifera_RNA__00	FAG_Morella_cerifera_RNA
FAG_Morella_cerifera_RNA__01	FAG_Morella_cerifera_RNA
FAG_Quercus_shumardii_RNA	FAG_Quercus_shumardii_RNA
FAG_Quercus_shumardii_RNA__00	FAG_Quercus_shumardii_RNA
FAG_Quercus_shumardii_RNA__01	FAG_Quercus_shumardii_RNA
FAG_Quercus_shumardii_RNA__02	FAG_Quercus_shumardii_RNA
FAKD__ref	FAKD__ref
FCCA__ref	FCCA__ref
FCEL__ref	FCEL__ref
FDMM__ref	FDMM__ref
FGDU__ref	FGDU__ref
FGRF__ref	FGRF__ref
FNEN__ref	FNEN__ref
FROP__ref	FROP__ref
FUPX__ref	FUPX__ref
FVXD__ref	FVXD__ref
FWBF__ref	FWBF__ref
FWCQ__ref	FWCQ__ref
FXGI__ref	FXGI__ref
FYSJ__ref	FYSJ__ref
FYTP__ref	FYTP__ref
FZJL__ref	FZJL__ref
GBVZ__ref	GBVZ__ref
GCFE__ref	GCFE__ref
GCYL__ref	GCYL__ref
GEHT__ref	GEHT__ref
GHLP__ref	GHLP__ref
GIPR__ref	GIPR__ref
GJNX__ref	GJNX__ref
GJPF__ref	GJPF__ref
GLVK__ref	GLVK__ref
GNPX__ref	GNPX__ref
GNRI__ref	GNRI__ref
GRFT__ref	GRFT__ref
GSZA__ref	GSZA__ref
GTSV__ref	GTSV__ref
GVCB__ref	GVCB__ref
HABV__ref	HABV__ref
HAEU__ref	HAEU__ref
HANM__ref	HANM__ref
HATH__ref	HATH__ref
HBHB__ref	HBHB__ref
HBUQ__ref	HBUQ__ref
HDSY__ref	HDSY__ref
HDWF__ref	HDWF__ref
HENI__ref	HENI__ref
HGSM__ref	HGSM__ref
HKMQ__ref	HKMQ__ref
HLJG__ref	HLJG__ref
HNCF__ref	HNCF__ref
HOKG__ref	HOKG__ref
HQRJ__ref	HQRJ__ref
HRUR__ref	HRUR__ref
HUSX__ref	HUSX__ref
HWUP__ref	HWUP__ref
HXCD__ref	HXCD__ref
HXJE__ref	HXJE__ref
HYZL__ref	HYZL__ref
HZTS__ref	HZTS__ref
IADP__ref	IADP__ref
IANR__ref	IANR__ref
ICNN__ref	ICNN__ref
IDAU__ref	IDAU__ref
IDGE__ref	IDGE__ref
IEPQ__ref	IEPQ__ref
IHCQ__ref	IHCQ__ref
IHPC__ref	IHPC__ref
IMZV__ref	IMZV__ref
INQX__ref	INQX__ref
INSP__ref	INSP__ref
IPWB__ref	IPWB__ref
IRAF__ref	IRAF__ref
IUSR__ref	IUSR__ref
IWIS__ref	IWIS__ref
IWMW__ref	IWMW__ref
IXEM__ref	IXEM__ref
IXVJ__ref	IXVJ__ref
IYDF__ref	IYDF__ref
IZNU__ref	IZNU__ref
JAFJ__ref	JAFJ__ref
JCLQ__ref	JCLQ__ref
JDTY__ref	JDTY__ref
JEPE__ref	JEPE__ref
JETM__ref	JETM__ref
JGAB__ref	JGAB__ref
JGYZ__ref	JGYZ__ref
JHUL__ref	JHUL__ref
JLOV__ref	JLOV__ref
JNKW__ref	JNKW__ref
JNUB__ref	JNUB__ref
JNVS__ref	JNVS__ref
JOIS__ref	JOIS__ref
JPDJ__ref	JPDJ__ref
JSAG__ref	JSAG__ref
JSZD__ref	JSZD__ref
JTQQ__ref	JTQQ__ref
JWEY__ref	JWEY__ref
JYMN__ref	JYMN__ref
KAYP__ref	KAYP__ref
KBRW__ref	KBRW__ref
KCPT__ref	KCPT__ref
KDCH__ref	KDCH__ref
KEGA__ref	KEGA__ref
KGJF__ref	KGJF__ref
KKDQ__ref	KKDQ__ref
KPTE__ref	KPTE__ref
KRJP__ref	KRJP__ref
KTAR__ref	KTAR__ref
KVAY__ref	KVAY__ref
KVFU__ref	KVFU__ref
KXSK__ref	KXSK__ref
KYAD__ref	KYAD__ref
KYNE__ref	KYNE__ref
LAPO__ref	LAPO__ref
LDEL__ref	LDEL__ref
LDME__ref	LDME__ref
LELS__ref	LELS__ref
LEMW__ref	LEMW__ref
LFOG__ref	LFOG__ref
LJQF__ref	LJQF__ref
LKKX__ref	LKKX__ref
LLQV__ref	LLQV__ref
LNER__ref	LNER__ref
LPGY__ref	LPGY__ref
LQJY__ref	LQJY__ref
LSJW__ref	LSJW__ref
LSKK__ref	LSKK__ref
LTZF__ref	LTZF__ref
LVUS__ref	LVUS__ref
LWCK__ref	LWCK__ref
LWDA__ref	LWDA__ref
LYPZ__ref	LYPZ__ref
MAQO__ref	MAQO__ref
MDJK__ref	MDJK__ref
MFIN__ref	MFIN__ref
MGVU__ref	MGVU__ref
MKZR__ref	MKZR__ref
MQIV__ref	MQIV__ref
MRKX__ref	MRKX__ref
MUMD__ref	MUMD__ref
MUNP__ref	MUNP__ref
MVSE__ref	MVSE__ref
MWYQ__ref	MWYQ__ref
MYMP__ref	MYMP__ref
MYVH__ref	MYVH__ref
MZOB__ref	MZOB__ref
Manes-v4.1__ref	Manes-v4.1__ref
Mimgu-v2.0__ref	Mimgu-v2.0__ref
NAUM__ref	NAUM__ref
NCVK__ref	NCVK__ref
NEBM__ref	NEBM__ref
NGRR__ref	NGRR__ref
NHAG__ref	NHAG__ref
NHUA__ref	NHUA__ref
NIGS__ref	NIGS__ref
NJLF__ref	NJLF__ref
NMDZ__ref	NMDZ__ref
NMGG__ref	NMGG__ref
NNGU__ref	NNGU__ref
NNOK__ref	NNOK__ref
NSPR__ref	NSPR__ref
NTEO__ref	NTEO__ref
NUZN__ref	NUZN__ref
NVSO__ref	NVSO__ref
NXOH__ref	NXOH__ref
NXTS__ref	NXTS__ref
OCTM__ref	OCTM__ref
ODDO__ref	ODDO__ref
OEKO__ref	OEKO__ref
OHKC__ref	OHKC__ref
OMDH__ref	OMDH__ref
OMYK__ref	OMYK__ref
ONBE__ref	ONBE__ref
ONLQ__ref	ONLQ__ref
OODC__ref	OODC__ref
OOSO__ref	OOSO__ref
OOVX__ref	OOVX__ref
OPDF__ref	OPDF__ref
OQBM__ref	OQBM__ref
OQHZ__ref	OQHZ__ref
OSHQ__ref	OSHQ__ref
OSIP__ref	OSIP__ref
OUER__ref	OUER__ref
OWAS__ref	OWAS__ref
OXYP__ref	OXYP__ref
Orysa__ref	Orysa__ref
PAZJ__ref	PAZJ__ref
PCNH__ref	PCNH__ref
PDQH__ref	PDQH__ref
PEZP__ref	PEZP__ref
PJSX__ref	PJSX__ref
PLBZ__ref	PLBZ__ref
PMTB__ref	PMTB__ref
POZS__ref	POZS__ref
PPPZ__ref	PPPZ__ref
PPQR__ref	PPQR__ref
PRFO__ref	PRFO__ref
PSHB__ref	PSHB__ref
PSJT__ref	PSJT__ref
PTLU__ref	PTLU__ref
PUCW__ref	PUCW__ref
PUDI__ref	PUDI__ref
PWSG__ref	PWSG__ref
PXYR__ref	PXYR__ref
Phavu-v1.0__ref	Phavu-v1.0__ref
Poptr-v3.0__ref	Poptr-v3.0__ref
Prupe-v1.0__ref	Prupe-v1.0__ref
QACK__ref	QACK__ref
QAUE__ref	QAUE__ref
QCOU__ref	QCOU__ref
QDVW__ref	QDVW__ref
QEHE__ref	QEHE__ref
QICX__ref	QICX__ref
QIKZ__ref	QIKZ__ref
QKMG__ref	QKMG__ref
QNPH__ref	QNPH__ref
QOXT__ref	QOXT__ref
QSKP__ref	QSKP__ref
QSLH__ref	QSLH__ref
QTJY__ref	QTJY__ref
QURC__ref	QURC__ref
QUTB__ref	QUTB__ref
QXWF__ref	QXWF__ref
QZXQ__ref	QZXQ__ref
QZZU__ref	QZZU__ref
RBYC__ref	RBYC__ref
RCUX__ref	RCUX__ref
RDYY__ref	RDYY__ref
RFSD__ref	RFSD__ref
RJIM__ref	RJIM__ref
RKLL__ref	RKLL__ref
RMWJ__ref	RMWJ__ref
ROEI__ref	ROEI__ref
ROLB__ref	ROLB__ref
ROS_Amelanchier_canadensis_RNA	ROS_Amelanchier_canadensis_RNA
ROS_Amelanchier_canadensis_RNA__00	ROS_Amelanchier_canadensis_RNA
ROS_Amelanchier_canadensis_RNA__01	ROS_Amelanchier_canadensis_RNA
ROS_Amelanchier_canadensis_RNA__02	ROS_Amelanchier_canadensis_RNA
ROS_Amelanchier_canadensis_RNA__03	ROS_Amelanchier_canadensis_RNA
ROS_Aruncus_dioicus_RNA	ROS_Aruncus_dioicus_RNA
ROS_Aruncus_dioicus_RNA__00	ROS_Aruncus_dioicus_RNA
ROS_Aruncus_dioicus_RNA__01	ROS_Aruncus_dioicus_RNA
ROS_Cannabis_sativa_core_RNA	ROS_Cannabis_sativa_core_RNA
ROS_Cannabis_sativa_core_RNA__00	ROS_Cannabis_sativa_core_RNA
ROS_Cannabis_sativa_core_RNA__01	ROS_Cannabis_sativa_core_RNA
ROS_Cannabis_sativa_core_RNA__02	ROS_Cannabis_sativa_core_RNA
ROS_Cannabis_sativa_core_RNA__03	ROS_Cannabis_sativa_core_RNA
ROS_Cannabis_sativa_stem_RNA	ROS_Cannabis_sativa_stem_RNA
ROS_Cannabis_sativa_stem_RNA__00	ROS_Cannabis_sativa_stem_RNA
ROS_Cannabis_sativa_stem_RNA__01	ROS_Cannabis_sativa_stem_RNA
ROS_Cannabis_sativa_stem_RNA__02	ROS_Cannabis_sativa_stem_RNA
ROS_Cannabis_sativa_stem_RNA__03	ROS_Cannabis_sativa_stem_RNA
ROS_Cannabis_sativa_stem_peel_RNA	ROS_Cannabis_sativa_stem_peel_RNA
ROS_Cannabis_sativa_stem_peel_RNA__00	ROS_Cannabis_sativa_stem_peel_RNA
ROS_Cannabis_sativa_stem_peel_RNA__01	ROS_Cannabis_sativa_stem_peel_RNA
ROS_Cannabis_sativa_stem_peel_RNA__02	ROS_Cannabis_sativa_stem_peel_RNA
ROS_Cannabis_sativa_stem_peel_RNA__03	ROS_Cannabis_sativa_stem_peel_RNA
ROS_Cannabis_sativa_xylem_RNA	ROS_Cannabis_sativa_xylem_RNA
ROS_Cannabis_sativa_xylem_RNA__00	ROS_Cannabis_sativa_xylem_RNA
ROS_Cannabis_sativa_xylem_RNA__01	ROS_Cannabis_sativa_xylem_RNA
ROS_Cannabis_sativa_xylem_RNA__02	ROS_Cannabis_sativa_xylem_RNA
ROS_Cannabis_sativa_xylem_RNA__03	ROS_Cannabis_sativa_xylem_RNA
ROS_Cannabis_sativa_xylem_RNA__04	ROS_Cannabis_sativa_xylem_RNA
ROS_Celtis_occidentalis_RNA	ROS_Celtis_occidentalis_RNA
ROS_Celtis_occidentalis_RNA__00	ROS_Celtis_occidentalis_RNA
ROS_Celtis_occidentalis_RNA__01	ROS_Celtis_occidentalis_RNA
ROS_Celtis_occidentalis_RNA__02	ROS_Celtis_occidentalis_RNA
ROS_Cercocarpus_ledifolius_RNA	ROS_Cercocarpus_ledifolius_RNA
ROS_Cercocarpus_ledifolius_RNA__00	ROS_Cercocarpus_ledifolius_RNA
ROS_Cercocarpus_ledifolius_RNA__01	ROS_Cercocarpus_ledifolius_RNA
ROS_Cercocarpus_ledifolius_RNA__02	ROS_Cercocarpus_ledifolius_RNA
ROS_Cotoneaster_transcaucasicus_RNA	ROS_Cotoneaster_transcaucasicus_RNA
ROS_Cotoneaster_transcaucasicus_RNA__00	ROS_Cotoneaster_transcaucasicus_RNA
ROS_Cotoneaster_transcaucasicus_RNA__01	ROS_Cotoneaster_transcaucasicus_RNA
ROS_Cotoneaster_transcaucasicus_RNA__02	ROS_Cotoneaster_transcaucasicus_RNA
ROS_Cotoneaster_transcaucasicus_RNA__03	ROS_Cotoneaster_transcaucasicus_RNA
ROS_Cotoneaster_transcaucasicus_RNA__04	ROS_Cotoneaster_transcaucasicus_RNA
ROS_Dryas_octopetala_RNA	ROS_Dryas_octopetala_RNA
ROS_Dryas_octopetala_RNA__00	ROS_Dryas_octopetala_RNA
ROS_Dryas_octopetala_RNA__01	ROS_Dryas_octopetala_RNA
ROS_Dryas_octopetala_RNA__02	ROS_Dryas_octopetala_RNA
ROS_Elaeagnus_pungens_RNA	ROS_Elaeagnus_pungens_RNA
ROS_Elaeagnus_pungens_RNA__00	ROS_Elaeagnus_pungens_RNA
ROS_Elaeagnus_pungens_RNA__01	ROS_Elaeagnus_pungens_RNA
ROS_Elaeagnus_pungens_RNA__02	ROS_Elaeagnus_pungens_RNA
ROS_Elaeagnus_pungens_RNA__03	ROS_Elaeagnus_pungens_RNA
ROS_Ficus_religiosa_RNA	ROS_Ficus_religiosa_RNA
ROS_Ficus_religiosa_RNA__00	ROS_Ficus_religiosa_RNA
ROS_Ficus_religiosa_RNA__01	ROS_Ficus_religiosa_RNA
ROS_Ficus_religiosa_RNA__02	ROS_Ficus_religiosa_RNA
ROS_Frangula_caroliniana_RNA	ROS_Frangula_caroliniana_RNA
ROS_Frangula_caroliniana_RNA__00	ROS_Frangula_caroliniana_RNA
ROS_Frangula_caroliniana_RNA__01	ROS_Frangula_caroliniana_RNA
ROS_Frangula_caroliniana_RNA__02	ROS_Frangula_caroliniana_RNA
ROS_Frangula_caroliniana_RNA__03	ROS_Frangula_caroliniana_RNA
ROS_Geum_quellyon_RNA	ROS_Geum_quellyon_RNA
ROS_Geum_quellyon_RNA__00	ROS_Geum_quellyon_RNA
ROS_Geum_quellyon_RNA__01	ROS_Geum_quellyon_RNA
ROS_Geum_quellyon_RNA__02	ROS_Geum_quellyon_RNA
ROS_Geum_quellyon_RNA__03	ROS_Geum_quellyon_RNA
ROS_Geum_quellyon_RNA__04	ROS_Geum_quellyon_RNA
ROS_Geum_quellyon_RNA__05	ROS_Geum_quellyon_RNA
ROS_Humulus_lupulus_RNA	ROS_Humulus_lupulus_RNA
ROS_Humulus_lupulus_RNA__00	ROS_Humulus_lupulus_RNA
ROS_Humulus_lupulus_RNA__01	ROS_Humulus_lupulus_RNA
ROS_Humulus_lupulus_RNA__02	ROS_Humulus_lupulus_RNA
ROS_Kerria_japonica_RNA	ROS_Kerria_japonica_RNA
ROS_Kerria_japonica_RNA__00	ROS_Kerria_japonica_RNA
ROS_Kerria_japonica_RNA__01	ROS_Kerria_japonica_RNA
ROS_Malus_baccata_RNA	ROS_Malus_baccata_RNA
ROS_Malus_baccata_RNA__00	ROS_Malus_baccata_RNA
ROS_Malus_baccata_RNA__01	ROS_Malus_baccata_RNA
ROS_Malus_baccata_RNA__02	ROS_Malus_baccata_RNA
ROS_Morus_nigra_RNA	ROS_Morus_nigra_RNA
ROS_Morus_nigra_RNA__00	ROS_Morus_nigra_RNA
ROS_Morus_nigra_RNA__01	ROS_Morus_nigra_RNA
ROS_Morus_nigra_RNA__02	ROS_Morus_nigra_RNA
ROS_Physocarpus_opulifolius_RNA	ROS_Physocarpus_opulifolius_RNA
ROS_Physocarpus_opulifolius_RNA__00	ROS_Physocarpus_opulifolius_RNA
ROS_Physocarpus_opulifolius_RNA__01	ROS_Physocarpus_opulifolius_RNA
ROS_Prunus_prostrata_RNA	ROS_Prunus_prostrata_RNA
ROS_Prunus_prostrata_RNA__00	ROS_Prunus_prostrata_RNA
ROS_Prunus_prostrata_RNA__01	ROS_Prunus_prostrata_RNA
ROS_Prunus_prostrata_RNA__02	ROS_Prunus_prostrata_RNA
ROS_Rhamnus_japonica_RNA	ROS_Rhamnus_japonica_RNA
ROS_Rhamnus_japonica_RNA__00	ROS_Rhamnus_japonica_RNA
ROS_Rhamnus_japonica_RNA__01	ROS_Rhamnus_japonica_RNA
ROS_Rhamnus_japonica_RNA__02	ROS_Rhamnus_japonica_RNA
ROS_Rhamnus_japonica_RNA__03	ROS_Rhamnus_japonica_RNA
ROS_Rosa_palustris_RNA	ROS_Rosa_palustris_RNA
ROS_Rosa_palustris_RNA__00	ROS_Rosa_palustris_RNA
ROS_Rosa_palustris_RNA__01	ROS_Rosa_palustris_RNA
ROS_Rosa_palustris_RNA__02	ROS_Rosa_palustris_RNA
ROS_Rosa_palustris_RNA__03	ROS_Rosa_palustris_RNA
ROS_Rosa_palustris_RNA__04	ROS_Rosa_palustris_RNA
ROS_Rosa_palustris_RNA__05	ROS_Rosa_palustris_RNA
ROS_Sanguisorba_minor_RNA	ROS_Sanguisorba_minor_RNA
ROS_Sanguisorba_minor_RNA__00	ROS_Sanguisorba_minor_RNA
ROS_Sanguisorba_minor_RNA__01	ROS_Sanguisorba_minor_RNA
ROS_Sanguisorba_minor_RNA__02	ROS_Sanguisorba_minor_RNA
ROS_Sanguisorba_minor_RNA__03	ROS_Sanguisorba_minor_RNA
ROS_Sorbus_koehneana_RNA	ROS_Sorbus_koehneana_RNA
ROS_Sorbus_koehneana_RNA__00	ROS_Sorbus_koehneana_RNA
ROS_Sorbus_koehneana_RNA__01	ROS_Sorbus_koehneana_RNA
ROS_Sorbus_koehneana_RNA__02	ROS_Sorbus_koehneana_RNA
ROS_Ulmus_alata_RNA	ROS_Ulmus_alata_RNA
ROS_Ulmus_alata_RNA__00	ROS_Ulmus_alata_RNA
ROS_Ulmus_alata_RNA__01	ROS_Ulmus_alata_RNA
ROS_Ulmus_alata_RNA__02	ROS_Ulmus_alata_RNA
ROS_Urtica_dioica_RNA	ROS_Urtica_dioica_RNA
ROS_Urtica_dioica_RNA__00	ROS_Urtica_dioica_RNA
ROS_Urtica_dioica_RNA__01	ROS_Urtica_dioica_RNA
ROS_Urtica_dioica_RNA__02	ROS_Urtica_dioica_RNA
ROS_Ziziphus_jujuba_RNA	ROS_Ziziphus_jujuba_RNA
ROS_Ziziphus_jujuba_RNA__00	ROS_Ziziphus_jujuba_RNA
ROS_Ziziphus_jujuba_RNA__01	ROS_Ziziphus_jujuba_RNA
ROS_Ziziphus_jujuba_RNA__02	ROS_Ziziphus_jujuba_RNA
RQNK__ref	RQNK__ref
RQZP__ref	RQZP__ref
RSPO__ref	RSPO__ref
RTNA__ref	RTNA__ref
RUUB__ref	RUUB__ref
RVGH__ref	RVGH__ref
RXEN__ref	RXEN__ref
RZTJ__ref	RZTJ__ref
SART__ref	SART__ref
SBZH__ref	SBZH__ref
SCAO__ref	SCAO__ref
SERM__ref	SERM__ref
SIIK__ref	SIIK__ref
SJAN__ref	SJAN__ref
SLOI__ref	SLOI__ref
SLYR__ref	SLYR__ref
SMMC__ref	SMMC__ref
SNNC__ref	SNNC__ref
SOHV__ref	SOHV__ref
SQCF__ref	SQCF__ref
SSDU__ref	SSDU__ref
SUAK__ref	SUAK__ref
SUVN__ref	SUVN__ref
SVVG__ref	SVVG__ref
SWGX__ref	SWGX__ref
SWOH__ref	SWOH__ref
SWPE__ref	SWPE__ref
SXCE__ref	SXCE__ref
SXML__ref	SXML__ref
Solly-iTAGv2.3__ref	Solly-iTAGv2.3__ref
Sorbi-v2.1__ref	Sorbi-v2.1__ref
TAGM__ref	TAGM__ref
TCYS__ref	TCYS__ref
TDTF__ref	TDTF__ref
TET_Octomeles_sp	TET_Octomeles_sp
TET_Octomeles_sp__00	TET_Octomeles_sp
TET_Octomeles_sp__01	TET_Octomeles_sp
TET_Octomeles_sp__02	TET_Octomeles_sp
TET_Tetrameles_nudiflora	TET_Tetrameles_nudiflora
TET_Tetrameles_nudiflora__00	TET_Tetrameles_nudiflora
TET_Tetrameles_nudiflora__01	TET_Tetrameles_nudiflora
TET_Tetrameles_nudiflora__02	TET_Tetrameles_nudiflora
TEZA__ref	TEZA__ref
THDM__ref	THDM__ref
THHD__ref	THHD__ref
TIUZ__ref	TIUZ__ref
TJLC__ref	TJLC__ref
TKEK__ref	TKEK__ref
TLCA__ref	TLCA__ref
TOKV__ref	TOKV__ref
TORX__ref	TORX__ref
TPEM__ref	TPEM__ref
TQKZ__ref	TQKZ__ref
TRRQ__ref	TRRQ__ref
TVSH__ref	TVSH__ref
TXMP__ref	TXMP__ref
TZNS__ref	TZNS__ref
TZWR__ref	TZWR__ref
Theca-v1.1__ref	Theca-v1.1__ref
UAXP__ref	UAXP__ref
UDHA__ref	UDHA__ref
UDUT__ref	UDUT__ref
UFHF__ref	UFHF__ref
UGJI__ref	UGJI__ref
UHBY__ref	UHBY__ref
UHJR__ref	UHJR__ref
UJGI__ref	UJGI__ref
UMUL__ref	UMUL__ref
UOEL__ref	UOEL__ref
UOYN__ref	UOYN__ref
UPOG__ref	UPOG__ref
UPZX__ref	UPZX__ref
UQCB__ref	UQCB__ref
UTQR__ref	UTQR__ref
UVDC__ref	UVDC__ref
UVQL__ref	UVQL__ref
UYED__ref	UYED__ref
UZWG__ref	UZWG__ref
UZXL__ref	UZXL__ref
VCIN__ref	VCIN__ref
VDKG__ref	VDKG__ref
VFFP__ref	VFFP__ref
VGHH__ref	VGHH__ref
VJPU__ref	VJPU__ref
VLNB__ref	VLNB__ref
VMNH__ref	VMNH__ref
VNMY__ref	VNMY__ref
VQFW__ref	VQFW__ref
VQYB__ref	VQYB__ref
VTLJ__ref	VTLJ__ref
VTUS__ref	VTUS__ref
VUSY__ref	VUSY__ref
VVPY__ref	VVPY__ref
VVVV__ref	VVVV__ref
VXKB__ref	VXKB__ref
VYDM__ref	VYDM__ref
VYGG__ref	VYGG__ref
VZCI__ref	VZCI__ref
Vitvi-Genoscope.12X__ref	Vitvi-Genoscope.12X__ref
WAIL__ref	WAIL__ref
WAXR__ref	WAXR__ref
WBIB__ref	WBIB__ref
WBOD__ref	WBOD__ref
WCOR__ref	WCOR__ref
WEAC__ref	WEAC__ref
WFBF__ref	WFBF__ref
WGET__ref	WGET__ref
WIGA__ref	WIGA__ref
WKCY__ref	WKCY__ref
WMLW__ref	WMLW__ref
WMUK__ref	WMUK__ref
WOBD__ref	WOBD__ref
WOHL__ref	WOHL__ref
WPHN__ref	WPHN__ref
WQUF__ref	WQUF__ref
WRPP__ref	WRPP__ref
WVEF__ref	WVEF__ref
WVMY__ref	WVMY__ref
WWKL__ref	WWKL__ref
WWQZ__ref	WWQZ__ref
WXNT__ref	WXNT__ref
WXVX__ref	WXVX__ref
WYIG__ref	WYIG__ref
WZFE__ref	WZFE__ref
XAYK__ref	XAYK__ref
XBKS__ref	XBKS__ref
XFFT__ref	XFFT__ref
XFJG__ref	XFJG__ref
XGFU__ref	XGFU__ref
XHHU__ref	XHHU__ref
XHKT__ref	XHKT__ref
XISJ__ref	XISJ__ref
XMVD__ref	XMVD__ref
XNLP__ref	XNLP__ref
XPAF__ref	XPAF__ref
XPBC__ref	XPBC__ref
XQRV__ref	XQRV__ref
XQWC__ref	XQWC__ref
XRCX__ref	XRCX__ref
XRLM__ref	XRLM__ref
XSZI__ref	XSZI__ref
XUAB__ref	XUAB__ref
XVJB__ref	XVJB__ref
XVRU__ref	XVRU__ref
XZME__ref	XZME__ref
YBML__ref	YBML__ref
YFQX__ref	YFQX__ref
YGCX__ref	YGCX__ref
YHLF__ref	YHLF__ref
YKFU__ref	YKFU__ref
YKQR__ref	YKQR__ref
YLWW__ref	YLWW__ref
YPIC__ref	YPIC__ref
YQIJ__ref	YQIJ__ref
YRBQ__ref	YRBQ__ref
YSRZ__ref	YSRZ__ref
YUOM__ref	YUOM__ref
YXNR__ref	YXNR__ref
YZRI__ref	YZRI__ref
YZVJ__ref	YZVJ__ref
ZBPY__ref	ZBPY__ref
ZBTA__ref	ZBTA__ref
ZBVT__ref	ZBVT__ref
ZCUA__ref	ZCUA__ref
ZENX__ref	ZENX__ref
ZETY__ref	ZETY__ref
ZGQD__ref	ZGQD__ref
ZHEE__ref	ZHEE__ref
ZHMB__ref	ZHMB__ref
ZINQ__ref	ZINQ__ref
ZJRC__ref	ZJRC__ref
ZJUL__ref	ZJUL__ref
ZKPF__ref	ZKPF__ref
ZMGN__ref	ZMGN__ref
ZPKK__ref	ZPKK__ref
ZRIN__ref	ZRIN__ref
ZSSR__ref	ZSSR__ref
ZTLR__ref	ZTLR__ref
ZUHO__ref	ZUHO__ref
